text,data,bss,dec,hex,filename
288759,2240,26648,317647,4d8cf,AFSK_Imperial_March
288591,1552,26648,316791,4d577,AFSK_Tone
288687,1552,26648,316887,4d5d7,AFSK_Tone_AM
293751,1552,26696,321999,4e9cf,APRS_MicE
293339,1552,26704,321595,4e83b,APRS_Position
293243,1552,26664,321459,4e7b3,APRS_Position_LoRa
290699,1552,26656,318907,4ddbb,AX25_Frames
290279,1552,26656,318487,4dc17,AX25_Transmit
290955,1552,26664,319171,4dec3,AX25_Transmit_AFSK
292247,1552,26672,320471,4e3d7,BellModem_Transmit
282063,1552,26616,310231,4bbd7,CC1101_Receive_Address
281879,1552,26616,310047,4bb1f,CC1101_Receive_Blocking
281999,1552,26616,310167,4bb97,CC1101_Receive_Interrupt
280675,1552,26976,309203,4b7d3,CC1101_Settings
280207,1552,26616,308375,4b497,CC1101_Transmit_Address
280827,1552,26616,308995,4b703,CC1101_Transmit_Blocking
280995,1552,26624,309171,4b7b3,CC1101_Transmit_Interrupt
289407,1604,26704,317715,4d913,FSK4_Transmit
289423,1604,26712,317739,4d92b,FSK4_Transmit_AFSK
292459,1552,26672,320683,4e4ab,Hellschreiber_Transmit
292539,1552,26680,320771,4e503,Hellschreiber_Transmit_AFSK
286919,1552,26656,315127,4cef7,LR11x0_Channel_Activity_Detection_Blocking
287171,1552,26664,315387,4cffb,LR11x0_Channel_Activity_Detection_Interrupt
288007,1552,26656,316215,4d337,LR11x0_GFSK_Modem
289191,1552,26736,317479,4d827,LR11x0_GNSS_Almanac_Update
289903,1552,26680,318135,4dab7,LR11x0_GNSS_Autonomous_Position
288639,1552,26672,316863,4d5bf,LR11x0_GNSS_Satellites
286663,1552,26664,314879,4cdff,LR11x0_LR_FHSS_Modem
289063,1552,26664,317279,4d75f,LR11x0_PingPong
288763,1552,26656,316971,4d62b,LR11x0_Receive_Blocking
288867,1552,26664,317083,4d69b,LR11x0_Receive_Interrupt
288983,1552,26664,317199,4d70f,LR11x0_Transmit_Blocking
287923,1552,26680,316155,4d2fb,LR11x0_Transmit_Interrupt
289979,1552,26656,318187,4daeb,LR11x0_WiFi_Scan_Blocking
290067,1552,26664,318283,4db4b,LR11x0_WiFi_Scan_Interrupt
309643,1552,28528,339723,52f0b,LoRaWAN_ABP
314663,1552,28624,344839,54307,LoRaWAN_Class_C
314779,1552,28632,344963,54383,LoRaWAN_Multicast
312583,1552,28544,342679,53a97,LoRaWAN_Reference
309575,1552,28544,339671,52ed7,LoRaWAN_Starter
311995,1560,29064,342619,53a5b,LoRaWAN_TS_Packages
290095,1552,26720,318367,4db9f,Morse_Receive_AM
292435,1552,26704,320691,4e4b3,Morse_Transmit_AM
292323,1552,26704,320579,4e443,Morse_Transmit_FM
292291,1552,26696,320539,4e41b,Morse_Transmit_SSB
291527,1556,26688,319771,4e11b,Pager_Receive
291583,1552,26688,319823,4e14f,Pager_Transmit
290639,1556,26632,318827,4dd6b,PhysicalLayer_Interface
279527,1552,26616,307695,4b1ef,RF69_Receive_AES
279795,1552,26616,307963,4b2fb,RF69_Receive_Address
280575,1552,26616,308743,4b607,RF69_Receive_Blocking
280671,1552,26624,308847,4b66f,RF69_Receive_Interrupt
279967,1552,26992,308511,4b51f,RF69_Settings
278935,1552,26616,307103,4af9f,RF69_Transmit_AES
279203,1552,26616,307371,4b0ab,RF69_Transmit_Address
279655,1552,26624,307831,4b277,RF69_Transmit_Blocking
279823,1552,26632,308007,4b327,RF69_Transmit_Interrupt
292563,1552,26680,320795,4e51b,RTTY_Transmit
292595,1552,26688,320835,4e543,RTTY_Transmit_AFSK
290403,2832,26768,320003,4e203,SSTV_Transmit
290451,2832,26776,320059,4e23b,SSTV_Transmit_AFSK
279579,1552,26624,307755,4b22b,SX123x_Receive_Blocking
279803,1552,26624,307979,4b30b,SX123x_Transmit_Blocking
291183,1552,26712,319447,4dfd7,SX126x_Channel_Activity_Detection_Blocking
291451,1552,26712,319715,4e0e3,SX126x_Channel_Activity_Detection_Interrupt
293811,1552,26712,322075,4ea1b,SX126x_Channel_Activity_Detection_Receive
292419,1552,26704,320675,4e4a3,SX126x_FSK_Modem
293231,1552,26712,321495,4e7d7,SX126x_LR_FHSS_Transmit_Blocking
292219,1552,26720,320491,4e3eb,SX126x_LR_FHSS_Transmit_Interrupt
293323,1552,26720,321595,4e83b,SX126x_PingPong
293363,1552,26712,321627,4e85b,SX126x_Receive_Blocking
293467,1552,26712,321731,4e8c3,SX126x_Receive_Interrupt
293259,1552,27152,321963,4e9ab,SX126x_Settings
293523,1552,26712,321787,4e8fb,SX126x_Spectrum_Scan
294791,1552,26712,323055,4edef,SX126x_Spectrum_Scan_Frequency
293247,1552,26712,321511,4e7e7,SX126x_Transmit_Blocking
292203,1552,26720,320475,4e3db,SX126x_Transmit_Interrupt
288287,1552,26640,316479,4d43f,SX127x_Channel_Activity_Detection_Blocking
288543,1552,26648,316743,4d547,SX127x_Channel_Activity_Detection_Interrupt
291111,1552,26648,319311,4df4f,SX127x_Channel_Activity_Detection_Receive
290083,1552,26640,318275,4db43,SX127x_FSK_Modem
290455,1552,26640,318647,4dcb7,SX127x_PingPong
290611,1552,26640,318803,4dd53,SX127x_Receive_Blocking
288539,1552,26632,316723,4d533,SX127x_Receive_Direct
289563,1580,26648,317791,4d95f,SX127x_Receive_FHSS
290743,1552,26648,318943,4dddf,SX127x_Receive_Interrupt
292775,1552,27024,321351,4e747,SX127x_Settings
290387,1552,26640,318579,4dc73,SX127x_Transmit_Blocking
290283,1580,26664,318527,4dc3f,SX127x_Transmit_FHSS
289335,1552,26648,317535,4d85f,SX127x_Transmit_Interrupt
283363,1552,26640,311555,4c103,SX128x_BLE_Modem
281943,1552,26640,310135,4bb77,SX128x_Channel_Activity_Detection_Blocking
282211,1552,26640,310403,4bc83,SX128x_Channel_Activity_Detection_Interrupt
283331,1552,26640,311523,4c0e3,SX128x_FLRC_Modem
283031,1552,26640,311223,4bfb7,SX128x_GFSK_Modem
284155,1552,26640,312347,4c41b,SX128x_Ranging
284123,1552,26640,312315,4c3fb,SX128x_Receive_Blocking
284243,1552,26640,312435,4c473,SX128x_Receive_Interrupt
282931,1552,27024,311507,4c0d3,SX128x_Settings
282795,1552,26640,310987,4becb,SX128x_Transmit_Blocking
282963,1552,26648,311163,4bf7b,SX128x_Transmit_Interrupt
280763,1552,26608,308923,4b6bb,Si443x_Receive_Blocking
280883,1552,26616,309051,4b73b,Si443x_Receive_Interrupt
280911,1552,26968,309431,4b8b7,Si443x_Settings
281043,1552,26616,309211,4b7db,Si443x_Transmit_Blocking
281171,1552,26624,309347,4b863,Si443x_Transmit_Interrupt
288723,1552,27168,317443,4d803,Stream_Receive
289379,1552,26664,317595,4d89b,Stream_Transmit
276975,1552,26608,305135,4a7ef,nRF24_Receive_Blocking
277115,1552,26608,305275,4a87b,nRF24_Receive_Interrupt
277255,1552,26608,305415,4a907,nRF24_Transmit_Blocking
277351,1552,26608,305511,4a967,nRF24_Transmit_Interrupt
