text,data,bss,dec,hex,filename
33298,740,775,34813,87fd,AFSK_Imperial_March
33038,396,775,34209,85a1,AFSK_Tone
33170,396,775,34341,8625,AFSK_Tone_AM
38058,446,810,39314,9992,APRS_MicE
38884,544,810,40238,9d2e,APRS_Position
37570,482,788,38840,97b8,APRS_Position_LoRa
35212,458,785,36455,8e67,AX25_Frames
34800,420,785,36005,8ca5,AX25_Transmit
35654,438,791,36883,9013,AX25_Transmit_AFSK
35828,466,798,37092,90e4,BellModem_Transmit
22456,434,759,23649,5c61,CC1101_Receive_Address
22336,434,759,23529,5be9,CC1101_Receive_Blocking
22432,434,760,23626,5c4a,CC1101_Receive_Interrupt
22622,534,1103,24259,5ec3,CC1101_Settings
21148,434,759,22341,5745,CC1101_Transmit_Address
22088,436,761,23285,5af5,CC1101_Transmit_Blocking
22190,450,764,23404,5b6c,CC1101_Transmit_Interrupt
33988,442,825,35255,89b7,FSK4_Transmit
34024,442,831,35297,89e1,FSK4_Transmit_AFSK
36186,442,791,37419,922b,Hellschreiber_Transmit
36298,458,797,37553,92b1,Hellschreiber_Transmit_AFSK
26942,614,797,28353,6ec1,LR11x0_Channel_Activity_Detection_Blocking
27182,614,798,28594,6fb2,LR11x0_Channel_Activity_Detection_Interrupt
28490,446,797,29733,7425,LR11x0_GFSK_Modem
27816,614,862,29292,726c,LR11x0_GNSS_Almanac_Update
28842,630,812,30284,764c,LR11x0_GNSS_Autonomous_Position
28706,622,801,30129,75b1,LR11x0_GNSS_Satellites
26878,442,797,28117,6dd5,LR11x0_LR_FHSS_Modem
28596,638,801,30035,7553,LR11x0_PingPong
28436,626,797,29859,74a3,LR11x0_Receive_Blocking
28522,626,798,29946,74fa,LR11x0_Receive_Interrupt
28354,640,799,29793,7461,LR11x0_Transmit_Blocking
28060,642,802,29504,7340,LR11x0_Transmit_Interrupt
30290,648,797,31735,7bf7,LR11x0_WiFi_Scan_Blocking
30408,648,798,31854,7c6e,LR11x0_WiFi_Scan_Interrupt
62326,1756,2097,66179,10283,LoRaWAN_ABP
68054,2016,2155,72225,11a21,LoRaWAN_Class_C
68144,2014,2157,72315,11a7b,LoRaWAN_Multicast
64634,1788,2095,68517,10ba5,LoRaWAN_Reference
62314,1756,2095,66165,10275,LoRaWAN_Starter
66038,1084,2610,69732,11064,LoRaWAN_TS_Packages
35310,406,828,36544,8ec0,Morse_Receive_AM
36378,434,826,37638,9306,Morse_Transmit_AM
36240,434,826,37500,927c,Morse_Transmit_FM
36204,434,820,37458,9252,Morse_Transmit_SSB
38936,408,808,40152,9cd8,Pager_Receive
38964,426,806,40196,9d04,Pager_Transmit
34680,422,769,35871,8c1f,PhysicalLayer_Interface
21650,398,762,22810,591a,RF69_Receive_AES
21916,382,762,23060,5a14,RF69_Receive_Address
21958,394,762,23114,5a4a,RF69_Receive_Blocking
22036,394,763,23193,5a99,RF69_Receive_Interrupt
22628,502,1109,24239,5eaf,RF69_Settings
20790,410,762,21962,55ca,RF69_Transmit_AES
21054,394,762,22210,56c2,RF69_Transmit_Address
21760,396,764,22920,5988,RF69_Transmit_Blocking
21866,410,767,23043,5a03,RF69_Transmit_Interrupt
36314,432,799,37545,92a9,RTTY_Transmit
36350,432,805,37587,92d3,RTTY_Transmit_AFSK
35100,1756,861,37717,9355,SSTV_Transmit
35156,1756,867,37779,9393,SSTV_Transmit_AFSK
21734,384,763,22881,5961,SX123x_Receive_Blocking
21796,398,765,22959,59af,SX123x_Transmit_Blocking
37184,632,825,38641,96f1,SX126x_Channel_Activity_Detection_Blocking
37408,632,826,38866,97d2,SX126x_Channel_Activity_Detection_Interrupt
39328,644,827,40799,9f5f,SX126x_Channel_Activity_Detection_Receive
38640,654,825,40119,9cb7,SX126x_FSK_Modem
38572,660,827,40059,9c7b,SX126x_LR_FHSS_Transmit_Blocking
38226,660,830,39716,9b24,SX126x_LR_FHSS_Transmit_Interrupt
38772,658,829,40259,9d43,SX126x_PingPong
38880,644,825,40349,9d9d,SX126x_Receive_Blocking
38964,644,826,40434,9df2,SX126x_Receive_Interrupt
40566,874,1233,42673,a6b1,SX126x_Settings
39546,644,825,41015,a037,SX126x_Spectrum_Scan
39986,662,825,41473,a201,SX126x_Spectrum_Scan_Frequency
38598,660,827,40085,9c95,SX126x_Transmit_Blocking
38308,660,830,39798,9b76,SX126x_Transmit_Interrupt
32638,396,769,33803,840b,SX127x_Channel_Activity_Detection_Blocking
32994,396,771,34161,8571,SX127x_Channel_Activity_Detection_Interrupt
35020,408,772,36200,8d68,SX127x_Channel_Activity_Detection_Receive
34858,418,769,36045,8ccd,SX127x_FSK_Modem
34326,422,773,35521,8ac1,SX127x_PingPong
34548,408,769,35725,8b8d,SX127x_Receive_Blocking
32712,438,769,33919,847f,SX127x_Receive_Direct
34232,420,773,35425,8a61,SX127x_Receive_FHSS
34646,408,770,35824,8bf0,SX127x_Receive_Interrupt
37936,630,1123,39689,9b09,SX127x_Settings
34144,424,771,35339,8a0b,SX127x_Transmit_Blocking
34736,642,783,36161,8d41,SX127x_Transmit_FHSS
33852,424,774,35050,88ea,SX127x_Transmit_Interrupt
25990,410,776,27176,6a28,SX128x_BLE_Modem
24392,398,776,25566,63de,SX128x_Channel_Activity_Detection_Blocking
24622,398,777,25797,64c5,SX128x_Channel_Activity_Detection_Interrupt
26058,418,776,27252,6a74,SX128x_FLRC_Modem
25672,416,776,26864,68f0,SX128x_GFSK_Modem
25880,446,776,27102,69de,SX128x_Ranging
26132,410,776,27318,6ab6,SX128x_Receive_Blocking
26228,410,777,27415,6b17,SX128x_Receive_Interrupt
25800,622,1137,27559,6ba7,SX128x_Settings
25420,412,778,26610,67f2,SX128x_Transmit_Blocking
25528,426,781,26735,686f,SX128x_Transmit_Interrupt
23814,384,757,24955,617b,Si443x_Receive_Blocking
23904,384,758,25046,61d6,Si443x_Receive_Interrupt
24116,500,1099,25715,6473,Si443x_Settings
23998,398,759,25155,6243,Si443x_Transmit_Blocking
24082,412,762,25256,62a8,Si443x_Transmit_Interrupt
33308,396,1285,34989,88ad,Stream_Receive
33710,910,783,35403,8a4b,Stream_Transmit
17360,386,746,18492,483c,nRF24_Receive_Blocking
17462,386,747,18595,48a3,nRF24_Receive_Interrupt
17696,402,748,18846,499e,nRF24_Transmit_Blocking
17772,414,751,18937,49f9,nRF24_Transmit_Interrupt
