text,data,bss,dec,hex,filename
58173,824,7700,66697,10489,AFSK_Imperial_March
58045,136,7700,65881,10159,AFSK_Tone
58133,136,7700,65969,101b1,AFSK_Tone_AM
63325,136,7756,71217,11631,APRS_MicE
63037,136,7756,70929,11511,APRS_Position
62845,136,7724,70705,11431,APRS_Position_LoRa
59901,136,7716,67753,108a9,AX25_Frames
59485,136,7716,67337,10709,AX25_Transmit
60109,136,7724,67969,10981,AX25_Transmit_AFSK
60933,136,7732,68801,10cc1,BellModem_Transmit
49597,136,7684,57417,e049,CC1101_Receive_Address
49445,136,7684,57265,dfb1,CC1101_Receive_Blocking
49541,136,7684,57361,e011,CC1101_Receive_Interrupt
49109,136,8044,57289,dfc9,CC1101_Settings
48621,136,7684,56441,dc79,CC1101_Transmit_Address
48965,136,7684,56785,ddd1,CC1101_Transmit_Blocking
49133,136,7692,56961,de81,CC1101_Transmit_Interrupt
58733,192,7756,66681,10479,FSK4_Transmit
58765,192,7764,66721,104a1,FSK4_Transmit_AFSK
61221,136,7732,69089,10de1,Hellschreiber_Transmit
61317,136,7740,69193,10e49,Hellschreiber_Transmit_AFSK
56437,136,7724,64297,fb29,LR11x0_Channel_Activity_Detection_Blocking
56613,136,7724,64473,fbd9,LR11x0_Channel_Activity_Detection_Interrupt
57245,136,7724,65105,fe51,LR11x0_GFSK_Modem
58533,136,7804,66473,103a9,LR11x0_GNSS_Almanac_Update
58749,136,7740,66625,10441,LR11x0_GNSS_Autonomous_Position
58005,136,7724,65865,10149,LR11x0_GNSS_Satellites
56125,136,7724,63985,f9f1,LR11x0_LR_FHSS_Modem
57789,136,7732,65657,10079,LR11x0_PingPong
57525,136,7724,65385,ff69,LR11x0_Receive_Blocking
57605,136,7724,65465,ffb9,LR11x0_Receive_Interrupt
57669,136,7724,65529,fff9,LR11x0_Transmit_Blocking
57133,136,7732,65001,fde9,LR11x0_Transmit_Interrupt
58669,136,7724,66529,103e1,LR11x0_WiFi_Scan_Blocking
58733,136,7724,66593,10421,LR11x0_WiFi_Scan_Interrupt
75277,136,9076,84489,14a09,LoRaWAN_ABP
77485,136,9084,86705,152b1,LoRaWAN_Reference
75229,136,9084,84449,149e1,LoRaWAN_Starter
59525,136,7772,67433,10769,Morse_Receive_AM
61373,136,7764,69273,10e99,Morse_Transmit_AM
61285,136,7764,69185,10e41,Morse_Transmit_FM
61253,136,7756,69145,10e19,Morse_Transmit_SSB
60517,144,7748,68409,10b39,Pager_Receive
60581,136,7748,68465,10b71,Pager_Transmit
59317,144,7692,67153,10651,PhysicalLayer_Interface
48829,136,7692,56657,dd51,RF69_Receive_AES
49045,136,7692,56873,de29,RF69_Receive_Address
49253,136,7692,57081,def9,RF69_Receive_Blocking
49341,136,7692,57169,df51,RF69_Receive_Interrupt
49437,136,8060,57633,e121,RF69_Settings
48493,136,7692,56321,dc01,RF69_Transmit_AES
48701,136,7692,56529,dcd1,RF69_Transmit_Address
48885,136,7692,56713,dd89,RF69_Transmit_Blocking
49053,136,7700,56889,de39,RF69_Transmit_Interrupt
61149,136,7740,69025,10da1,RTTY_Transmit
61181,136,7748,69065,10dc9,RTTY_Transmit_AFSK
59581,1416,7828,68825,10cd9,SSTV_Transmit
59653,1416,7836,68905,10d29,SSTV_Transmit_AFSK
48901,136,7692,56729,dd99,SX123x_Receive_Blocking
49045,136,7692,56873,de29,SX123x_Transmit_Blocking
59981,136,7764,67881,10929,SX126x_Channel_Activity_Detection_Blocking
60165,136,7764,68065,109e1,SX126x_Channel_Activity_Detection_Interrupt
61813,136,7764,69713,11051,SX126x_Channel_Activity_Detection_Receive
60949,136,7764,68849,10cf1,SX126x_FSK_Modem
60309,136,7764,68209,10a71,SX126x_LR_FHSS_Modem
61221,136,7772,69129,10e09,SX126x_PingPong
61429,136,7764,69329,10ed1,SX126x_Receive_Blocking
61517,136,7764,69417,10f29,SX126x_Receive_Interrupt
61909,136,8204,70249,11269,SX126x_Settings
62181,136,7764,70081,111c1,SX126x_Spectrum_Scan
62749,136,7764,70649,113f9,SX126x_Spectrum_Scan_Frequency
61093,136,7764,68993,10d81,SX126x_Transmit_Blocking
60677,136,7772,68585,10be9,SX126x_Transmit_Interrupt
57789,136,7692,65617,10051,SX127x_Channel_Activity_Detection_Blocking
57973,136,7700,65809,10111,SX127x_Channel_Activity_Detection_Interrupt
59701,136,7700,67537,107d1,SX127x_Channel_Activity_Detection_Receive
59277,136,7692,67105,10621,SX127x_FSK_Modem
59061,136,7708,66905,10559,SX127x_PingPong
59277,136,7692,67105,10621,SX127x_Receive_Blocking
57997,136,7692,65825,10121,SX127x_Receive_Direct
58741,168,7708,66617,10439,SX127x_Receive_FHSS
59397,136,7700,67233,106a1,SX127x_Receive_Interrupt
61909,136,8068,70113,111e1,SX127x_Settings
58925,136,7700,66761,104c9,SX127x_Transmit_Blocking
59309,168,7724,67201,10681,SX127x_Transmit_FHSS
58517,136,7708,66361,10339,SX127x_Transmit_Interrupt
52021,136,7692,59849,e9c9,SX128x_BLE_Modem
50885,136,7692,58713,e559,SX128x_Channel_Activity_Detection_Blocking
51069,136,7700,58905,e619,SX128x_Channel_Activity_Detection_Interrupt
52037,136,7692,59865,e9d9,SX128x_FLRC_Modem
51709,136,7692,59537,e891,SX128x_GFSK_Modem
52637,136,7692,60465,ec31,SX128x_Ranging
52469,136,7692,60297,eb89,SX128x_Receive_Blocking
52557,136,7700,60393,ebe9,SX128x_Receive_Interrupt
51845,136,8068,60049,ea91,SX128x_Settings
51421,136,7700,59257,e779,SX128x_Transmit_Blocking
51589,136,7708,59433,e829,SX128x_Transmit_Interrupt
49885,136,7676,57697,e161,Si443x_Receive_Blocking
49989,136,7684,57809,e1d1,Si443x_Receive_Interrupt
50285,136,8036,58457,e459,Si443x_Settings
50085,136,7684,57905,e231,Si443x_Transmit_Blocking
50229,136,7692,58057,e2c9,Si443x_Transmit_Interrupt
58109,136,8220,66465,103a1,Stream_Receive
58685,136,7724,66545,103f1,Stream_Transmit
43613,136,7668,51417,c8d9,nRF24_Receive_Blocking
43717,136,7668,51521,c941,nRF24_Receive_Interrupt
43805,136,7668,51609,c999,nRF24_Transmit_Blocking
43909,136,7676,51721,ca09,nRF24_Transmit_Interrupt
