text,data,bss,dec,hex,filename
869856,12,178556,1048424,fff68,AFSK_Imperial_March
869000,12,178556,1047568,ffc10,AFSK_Tone
869096,12,178556,1047664,ffc70,AFSK_Tone_AM
873800,12,178612,1052424,100f08,APRS_MicE
873648,12,178612,1052272,100e70,APRS_Position
872192,12,178580,1050784,1008a0,APRS_Position_LoRa
870784,12,178572,1049368,100318,AX25_Frames
870400,12,178572,1048984,100198,AX25_Transmit
872224,12,178580,1050816,1008c0,AX25_Transmit_AFSK
872776,12,178588,1051376,100af0,BellModem_Transmit
862304,12,178532,1040848,fe1d0,CC1101_Receive_Address
862144,12,178532,1040688,fe130,CC1101_Receive_Blocking
862216,12,178532,1040760,fe178,CC1101_Receive_Interrupt
861856,12,178892,1040760,fe178,CC1101_Settings
861376,12,178532,1039920,fde30,CC1101_Transmit_Address
861888,12,178536,1040436,fe034,CC1101_Transmit_Blocking
862016,12,178540,1040568,fe0b8,CC1101_Transmit_Interrupt
869572,12,178612,1048196,ffe84,FSK4_Transmit
869604,12,178620,1048236,ffeac,FSK4_Transmit_AFSK
871792,12,178584,1050388,100714,Hellschreiber_Transmit
871896,12,178592,1050500,100784,Hellschreiber_Transmit_AFSK
866912,12,178576,1045500,ff3fc,LR11x0_Channel_Activity_Detection_Blocking
867112,12,178576,1045700,ff4c4,LR11x0_Channel_Activity_Detection_Interrupt
1112656,12,178576,1291244,13b3ec,LR11x0_Firmware_Update
867760,12,178576,1046348,ff74c,LR11x0_GFSK_Modem
868816,12,178656,1047484,ffbbc,LR11x0_GNSS_Almanac_Update
868864,12,178592,1047468,ffbac,LR11x0_GNSS_Autonomous_Position
868360,12,178580,1046952,ff9a8,LR11x0_GNSS_Satellites
866656,12,178576,1045244,ff2fc,LR11x0_LR_FHSS_Modem
868112,12,178584,1046708,ff8b4,LR11x0_PingPong
867888,12,178576,1046476,ff7cc,LR11x0_Receive_Blocking
867952,12,178576,1046540,ff80c,LR11x0_Receive_Interrupt
868112,12,178580,1046704,ff8b0,LR11x0_Transmit_Blocking
867752,12,178584,1046348,ff74c,LR11x0_Transmit_Interrupt
868944,12,178576,1047532,ffbec,LR11x0_WiFi_Scan_Blocking
869000,12,178576,1047588,ffc24,LR11x0_WiFi_Scan_Interrupt
886568,12,180048,1066628,104684,LoRaWAN_ABP
889160,12,180136,1069308,1050fc,LoRaWAN_Class_C
889224,12,180140,1069376,105140,LoRaWAN_Multicast
888480,12,180060,1068552,104e08,LoRaWAN_Reference
886480,12,180060,1066552,104638,LoRaWAN_Starter
887748,12,180584,1068344,104d38,LoRaWAN_TS_Packages
870160,12,178624,1048796,1000dc,Morse_Receive_AM
871712,12,178620,1050344,1006e8,Morse_Transmit_AM
871616,12,178620,1050248,100688,Morse_Transmit_FM
871584,12,178612,1050208,100660,Morse_Transmit_SSB
871316,12,178604,1049932,10054c,Pager_Receive
871336,12,178600,1049948,10055c,Pager_Transmit
870300,12,178552,1048864,100120,PhysicalLayer_Interface
861240,12,178536,1039788,fddac,RF69_Receive_AES
861456,12,178536,1040004,fde84,RF69_Receive_Address
861568,12,178536,1040116,fdef4,RF69_Receive_Blocking
861632,12,178536,1040180,fdf34,RF69_Receive_Interrupt
861752,12,178900,1040664,fe118,RF69_Settings
860832,12,178536,1039380,fdc14,RF69_Transmit_AES
861016,12,178536,1039564,fdccc,RF69_Transmit_Address
861392,12,178540,1039944,fde48,RF69_Transmit_Blocking
861520,12,178544,1040076,fdecc,RF69_Transmit_Interrupt
871648,12,178592,1050252,10068c,RTTY_Transmit
871680,12,178600,1050292,1006b4,RTTY_Transmit_AFSK
871816,12,178684,1050512,100790,SSTV_Transmit
871848,12,178692,1050552,1007b8,SSTV_Transmit_AFSK
861344,12,178540,1039896,fde18,SX123x_Receive_Blocking
861576,12,178544,1040132,fdf04,SX123x_Transmit_Blocking
870232,12,178620,1048864,100120,SX126x_Channel_Activity_Detection_Blocking
870408,12,178620,1049040,1001d0,SX126x_Channel_Activity_Detection_Interrupt
871832,12,178624,1050468,100764,SX126x_Channel_Activity_Detection_Receive
871224,12,178620,1049856,100500,SX126x_FSK_Modem
871376,12,178624,1050012,10059c,SX126x_LR_FHSS_Transmit_Blocking
871048,12,178628,1049688,100458,SX126x_LR_FHSS_Transmit_Interrupt
871408,12,178628,1050048,1005c0,SX126x_PingPong
871472,12,178620,1050104,1005f8,SX126x_Receive_Blocking
871536,12,178620,1050168,100638,SX126x_Receive_Interrupt
872136,12,179068,1051216,100a50,SX126x_Settings
872328,12,178620,1050960,100950,SX126x_Spectrum_Scan
872848,12,178620,1051480,100b58,SX126x_Spectrum_Scan_Frequency
871408,12,178624,1050044,1005bc,SX126x_Transmit_Blocking
871048,12,178628,1049688,100458,SX126x_Transmit_Interrupt
868808,12,178548,1047368,ffb48,SX127x_Channel_Activity_Detection_Blocking
868976,12,178552,1047540,ffbf4,SX127x_Channel_Activity_Detection_Interrupt
870544,12,178552,1049108,100214,SX127x_Channel_Activity_Detection_Receive
870376,12,178548,1048936,100168,SX127x_FSK_Modem
870000,12,178556,1048568,ffff8,SX127x_PingPong
870200,12,178548,1048760,1000b8,SX127x_Receive_Blocking
868920,12,178548,1047480,ffbb8,SX127x_Receive_Direct
869804,12,178560,1048376,fff38,SX127x_Receive_FHSS
870288,12,178548,1048848,100110,SX127x_Receive_Interrupt
872720,12,178924,1051656,100c08,SX127x_Settings
870000,12,178552,1048564,ffff4,SX127x_Transmit_Blocking
870420,12,178580,1049012,1001b4,SX127x_Transmit_FHSS
869640,12,178556,1048208,ffe90,SX127x_Transmit_Interrupt
863696,12,178552,1042260,fe754,SX128x_BLE_Modem
862488,12,178552,1041052,fe29c,SX128x_Channel_Activity_Detection_Blocking
862696,12,178552,1041260,fe36c,SX128x_Channel_Activity_Detection_Interrupt
863696,12,178552,1042260,fe754,SX128x_FLRC_Modem
863384,12,178552,1041948,fe61c,SX128x_GFSK_Modem
864152,12,178552,1042716,fe91c,SX128x_Ranging
864048,12,178552,1042612,fe8b4,SX128x_Receive_Blocking
864112,12,178552,1042676,fe8f4,SX128x_Receive_Interrupt
863392,12,178932,1042336,fe7a0,SX128x_Settings
863208,12,178556,1041776,fe570,SX128x_Transmit_Blocking
863336,12,178560,1041908,fe5f4,SX128x_Transmit_Interrupt
862112,12,178528,1040652,fe10c,Si443x_Receive_Blocking
862176,12,178528,1040716,fe14c,Si443x_Receive_Interrupt
862416,12,178884,1041312,fe3a0,Si443x_Settings
862384,12,178532,1040928,fe220,Si443x_Transmit_Blocking
862504,12,178536,1041052,fe29c,Si443x_Transmit_Interrupt
869080,12,179068,1048160,ffe60,Stream_Receive
869816,12,178576,1048404,fff54,Stream_Transmit
858808,12,178516,1037336,fd418,nRF24_Receive_Blocking
858896,12,178516,1037424,fd470,nRF24_Receive_Interrupt
859096,12,178520,1037628,fd53c,nRF24_Transmit_Blocking
859168,12,178524,1037704,fd588,nRF24_Transmit_Interrupt
