text,data,bss,dec,hex,filename
288871,2240,26632,317743,4d92f,AFSK_Imperial_March
288703,1552,26632,316887,4d5d7,AFSK_Tone
288815,1552,26632,316999,4d647,AFSK_Tone_AM
293911,1552,26680,322143,4ea5f,APRS_MicE
293499,1552,26688,321739,4e8cb,APRS_Position
293371,1552,26648,321571,4e823,APRS_Position_LoRa
290827,1552,26640,319019,4de2b,AX25_Frames
290407,1552,26640,318599,4dc87,AX25_Transmit
291115,1552,26648,319315,4df53,AX25_Transmit_AFSK
292407,1552,26656,320615,4e467,BellModem_Transmit
281535,1552,26608,309695,4b9bf,CC1101_Receive_Address
281351,1552,26608,309511,4b907,CC1101_Receive_Blocking
281471,1552,26608,309631,4b97f,CC1101_Receive_Interrupt
280147,1552,26968,308667,4b5bb,CC1101_Settings
279695,1552,26608,307855,4b28f,CC1101_Transmit_Address
280315,1552,26608,308475,4b4fb,CC1101_Transmit_Blocking
280483,1552,26616,308651,4b5ab,CC1101_Transmit_Interrupt
289567,1604,26688,317859,4d9a3,FSK4_Transmit
289583,1604,26696,317883,4d9bb,FSK4_Transmit_AFSK
292635,1552,26656,320843,4e54b,Hellschreiber_Transmit
292731,1552,26664,320947,4e5b3,Hellschreiber_Transmit_AFSK
286903,1552,26648,315103,4cedf,LR11x0_Channel_Activity_Detection_Blocking
287155,1552,26648,315355,4cfdb,LR11x0_Channel_Activity_Detection_Interrupt
287991,1552,26648,316191,4d31f,LR11x0_GFSK_Modem
289191,1552,26728,317471,4d81f,LR11x0_GNSS_Almanac_Update
289887,1552,26672,318111,4da9f,LR11x0_GNSS_Autonomous_Position
288639,1552,26656,316847,4d5af,LR11x0_GNSS_Satellites
286647,1552,26656,314855,4cde7,LR11x0_LR_FHSS_Modem
289031,1552,26656,317239,4d737,LR11x0_PingPong
288731,1552,26648,316931,4d603,LR11x0_Receive_Blocking
288851,1552,26648,317051,4d67b,LR11x0_Receive_Interrupt
288967,1552,26648,317167,4d6ef,LR11x0_Transmit_Blocking
287907,1552,26664,316123,4d2db,LR11x0_Transmit_Interrupt
289947,1552,26648,318147,4dac3,LR11x0_WiFi_Scan_Blocking
290035,1552,26648,318235,4db1b,LR11x0_WiFi_Scan_Interrupt
307567,1552,27984,337103,524cf,LoRaWAN_ABP
310491,1552,28008,340051,53053,LoRaWAN_Reference
307499,1552,28000,337051,5249b,LoRaWAN_Starter
290271,1552,26704,318527,4dc3f,Morse_Receive_AM
292595,1552,26688,320835,4e543,Morse_Transmit_AM
292499,1552,26688,320739,4e4e3,Morse_Transmit_FM
292467,1552,26680,320699,4e4bb,Morse_Transmit_SSB
291703,1556,26672,319931,4e1bb,Pager_Receive
291727,1552,26672,319951,4e1cf,Pager_Transmit
290767,1556,26616,318939,4dddb,PhysicalLayer_Interface
279335,1552,26616,307503,4b12f,RF69_Receive_AES
279619,1552,26616,307787,4b24b,RF69_Receive_Address
280383,1552,26616,308551,4b547,RF69_Receive_Blocking
280495,1552,26616,308663,4b5b7,RF69_Receive_Interrupt
279791,1552,26992,308335,4b46f,RF69_Settings
278743,1552,26616,306911,4aedf,RF69_Transmit_AES
279027,1552,26616,307195,4affb,RF69_Transmit_Address
279463,1552,26616,307631,4b1af,RF69_Transmit_Blocking
279631,1552,26624,307807,4b25f,RF69_Transmit_Interrupt
292723,1552,26664,320939,4e5ab,RTTY_Transmit
292755,1552,26672,320979,4e5d3,RTTY_Transmit_AFSK
290595,2832,26752,320179,4e2b3,SSTV_Transmit
290643,2832,26760,320235,4e2eb,SSTV_Transmit_AFSK
279355,1552,26616,307523,4b143,SX123x_Receive_Blocking
279579,1552,26616,307747,4b223,SX123x_Transmit_Blocking
291111,1552,26688,319351,4df77,SX126x_Channel_Activity_Detection_Blocking
291379,1552,26688,319619,4e083,SX126x_Channel_Activity_Detection_Interrupt
293803,1552,26688,322043,4e9fb,SX126x_Channel_Activity_Detection_Receive
292347,1552,26696,320595,4e453,SX126x_FSK_Modem
291435,1552,26688,319675,4e0bb,SX126x_LR_FHSS_Modem
293251,1552,26696,321499,4e7db,SX126x_PingPong
293339,1552,26688,321579,4e82b,SX126x_Receive_Blocking
293459,1552,26688,321699,4e8a3,SX126x_Receive_Interrupt
293119,1552,27136,321807,4e90f,SX126x_Settings
293463,1552,26696,321711,4e8af,SX126x_Spectrum_Scan
294719,1552,26688,322959,4ed8f,SX126x_Spectrum_Scan_Frequency
293171,1552,26688,321411,4e783,SX126x_Transmit_Blocking
292131,1552,26696,320379,4e37b,SX126x_Transmit_Interrupt
288415,1552,26624,316591,4d4af,SX127x_Channel_Activity_Detection_Blocking
288671,1552,26632,316855,4d5b7,SX127x_Channel_Activity_Detection_Interrupt
291367,1552,26632,319551,4e03f,SX127x_Channel_Activity_Detection_Receive
290211,1552,26624,318387,4dbb3,SX127x_FSK_Modem
290583,1552,26624,318759,4dd27,SX127x_PingPong
290851,1552,26624,319027,4de33,SX127x_Receive_Blocking
288667,1552,26616,316835,4d5a3,SX127x_Receive_Direct
289707,1580,26632,317919,4d9df,SX127x_Receive_FHSS
290999,1552,26632,319183,4decf,SX127x_Receive_Interrupt
292791,1552,27000,321343,4e73f,SX127x_Settings
290515,1552,26624,318691,4dce3,SX127x_Transmit_Blocking
290411,1580,26648,318639,4dcaf,SX127x_Transmit_FHSS
289463,1552,26632,317647,4d8cf,SX127x_Transmit_Interrupt
282291,1552,26616,310459,4bcbb,SX128x_BLE_Modem
280887,1552,26616,309055,4b73f,SX128x_Channel_Activity_Detection_Blocking
281139,1552,26624,309315,4b843,SX128x_Channel_Activity_Detection_Interrupt
282275,1552,26616,310443,4bcab,SX128x_FLRC_Modem
281959,1552,26616,310127,4bb6f,SX128x_GFSK_Modem
283499,1552,26616,311667,4c173,SX128x_Ranging
283499,1552,26616,311667,4c173,SX128x_Receive_Blocking
283603,1552,26624,311779,4c1e3,SX128x_Receive_Interrupt
281875,1552,26992,310419,4bc93,SX128x_Settings
281723,1552,26624,309899,4ba8b,SX128x_Transmit_Blocking
281891,1552,26632,310075,4bb3b,SX128x_Transmit_Interrupt
280955,1552,26600,309107,4b773,Si443x_Receive_Blocking
281075,1552,26608,309235,4b7f3,Si443x_Receive_Interrupt
281103,1552,26960,309615,4b96f,Si443x_Settings
281235,1552,26608,309395,4b893,Si443x_Transmit_Blocking
281363,1552,26616,309531,4b91b,Si443x_Transmit_Interrupt
288851,1552,27152,317555,4d873,Stream_Receive
289507,1552,26648,317707,4d90b,Stream_Transmit
276719,1552,26600,304871,4a6e7,nRF24_Receive_Blocking
276859,1552,26600,305011,4a773,nRF24_Receive_Interrupt
276999,1552,26600,305151,4a7ff,nRF24_Transmit_Blocking
277095,1552,26600,305247,4a85f,nRF24_Transmit_Interrupt
