text,data,bss,dec,hex,filename
33246,736,775,34757,87c5,AFSK_Imperial_March
32986,392,775,34153,8569,AFSK_Tone
33118,392,775,34285,85ed,AFSK_Tone_AM
38006,442,810,39258,995a,APRS_MicE
38832,540,810,40182,9cf6,APRS_Position
37518,478,788,38784,9780,APRS_Position_LoRa
35160,454,785,36399,8e2f,AX25_Frames
34748,416,785,35949,8c6d,AX25_Transmit
35602,434,791,36827,8fdb,AX25_Transmit_AFSK
35776,462,798,37036,90ac,BellModem_Transmit
22422,430,759,23611,5c3b,CC1101_Receive_Address
22302,430,759,23491,5bc3,CC1101_Receive_Blocking
22398,430,760,23588,5c24,CC1101_Receive_Interrupt
22338,418,1103,23859,5d33,CC1101_Settings
21114,430,759,22303,571f,CC1101_Transmit_Address
22054,432,761,23247,5acf,CC1101_Transmit_Blocking
22156,446,764,23366,5b46,CC1101_Transmit_Interrupt
33936,438,825,35199,897f,FSK4_Transmit
33972,438,831,35241,89a9,FSK4_Transmit_AFSK
36134,438,791,37363,91f3,Hellschreiber_Transmit
36246,454,797,37497,9279,Hellschreiber_Transmit_AFSK
26922,610,797,28329,6ea9,LR11x0_Channel_Activity_Detection_Blocking
27162,610,798,28570,6f9a,LR11x0_Channel_Activity_Detection_Interrupt
28470,442,797,29709,740d,LR11x0_GFSK_Modem
27796,610,862,29268,7254,LR11x0_GNSS_Almanac_Update
28822,626,812,30260,7634,LR11x0_GNSS_Autonomous_Position
28686,618,801,30105,7599,LR11x0_GNSS_Satellites
26858,438,797,28093,6dbd,LR11x0_LR_FHSS_Modem
28576,634,801,30011,753b,LR11x0_PingPong
28416,622,797,29835,748b,LR11x0_Receive_Blocking
28502,622,798,29922,74e2,LR11x0_Receive_Interrupt
28334,636,799,29769,7449,LR11x0_Transmit_Blocking
28040,638,802,29480,7328,LR11x0_Transmit_Interrupt
30270,644,797,31711,7bdf,LR11x0_WiFi_Scan_Blocking
30388,644,798,31830,7c56,LR11x0_WiFi_Scan_Interrupt
62274,1752,2097,66123,1024b,LoRaWAN_ABP
68028,2012,2155,72195,11a03,LoRaWAN_Class_C
68118,2010,2157,72285,11a5d,LoRaWAN_Multicast
64582,1784,2095,68461,10b6d,LoRaWAN_Reference
62262,1752,2095,66109,1023d,LoRaWAN_Starter
65986,1080,2610,69676,1102c,LoRaWAN_TS_Packages
35258,402,828,36488,8e88,Morse_Receive_AM
36326,430,826,37582,92ce,Morse_Transmit_AM
36188,430,826,37444,9244,Morse_Transmit_FM
36152,430,820,37402,921a,Morse_Transmit_SSB
38884,404,808,40096,9ca0,Pager_Receive
38912,422,806,40140,9ccc,Pager_Transmit
34628,418,769,35815,8be7,PhysicalLayer_Interface
21636,394,762,22792,5908,RF69_Receive_AES
21902,378,762,23042,5a02,RF69_Receive_Address
21944,390,762,23096,5a38,RF69_Receive_Blocking
22022,390,763,23175,5a87,RF69_Receive_Interrupt
22348,386,1109,23843,5d23,RF69_Settings
20776,406,762,21944,55b8,RF69_Transmit_AES
21040,390,762,22192,56b0,RF69_Transmit_Address
21746,392,764,22902,5976,RF69_Transmit_Blocking
21852,406,767,23025,59f1,RF69_Transmit_Interrupt
36262,428,799,37489,9271,RTTY_Transmit
36298,428,805,37531,929b,RTTY_Transmit_AFSK
35048,1752,861,37661,931d,SSTV_Transmit
35104,1752,867,37723,935b,SSTV_Transmit_AFSK
21714,380,763,22857,5949,SX123x_Receive_Blocking
21776,394,765,22935,5997,SX123x_Transmit_Blocking
37158,628,825,38611,96d3,SX126x_Channel_Activity_Detection_Blocking
37382,628,826,38836,97b4,SX126x_Channel_Activity_Detection_Interrupt
39302,640,827,40769,9f41,SX126x_Channel_Activity_Detection_Receive
38614,650,825,40089,9c99,SX126x_FSK_Modem
38546,656,827,40029,9c5d,SX126x_LR_FHSS_Transmit_Blocking
38200,656,830,39686,9b06,SX126x_LR_FHSS_Transmit_Interrupt
38746,654,829,40229,9d25,SX126x_PingPong
38854,640,825,40319,9d7f,SX126x_Receive_Blocking
38938,640,826,40404,9dd4,SX126x_Receive_Interrupt
39846,872,1233,41951,a3df,SX126x_Settings
39520,640,825,40985,a019,SX126x_Spectrum_Scan
39960,658,825,41443,a1e3,SX126x_Spectrum_Scan_Frequency
38572,656,827,40055,9c77,SX126x_Transmit_Blocking
38282,656,830,39768,9b58,SX126x_Transmit_Interrupt
32586,392,769,33747,83d3,SX127x_Channel_Activity_Detection_Blocking
32942,392,771,34105,8539,SX127x_Channel_Activity_Detection_Interrupt
34968,404,772,36144,8d30,SX127x_Channel_Activity_Detection_Receive
34806,414,769,35989,8c95,SX127x_FSK_Modem
34274,418,773,35465,8a89,SX127x_PingPong
34496,404,769,35669,8b55,SX127x_Receive_Blocking
32660,434,769,33863,8447,SX127x_Receive_Direct
34180,416,773,35369,8a29,SX127x_Receive_FHSS
34594,404,770,35768,8bb8,SX127x_Receive_Interrupt
37876,618,1123,39617,9ac1,SX127x_Settings
34092,420,771,35283,89d3,SX127x_Transmit_Blocking
34684,638,783,36105,8d09,SX127x_Transmit_FHSS
33800,420,774,34994,88b2,SX127x_Transmit_Interrupt
25964,406,776,27146,6a0a,SX128x_BLE_Modem
24366,394,776,25536,63c0,SX128x_Channel_Activity_Detection_Blocking
24596,394,777,25767,64a7,SX128x_Channel_Activity_Detection_Interrupt
26032,414,776,27222,6a56,SX128x_FLRC_Modem
25646,412,776,26834,68d2,SX128x_GFSK_Modem
25854,442,776,27072,69c0,SX128x_Ranging
26106,406,776,27288,6a98,SX128x_Receive_Blocking
26202,406,777,27385,6af9,SX128x_Receive_Interrupt
25766,502,1137,27405,6b0d,SX128x_Settings
25394,408,778,26580,67d4,SX128x_Transmit_Blocking
25502,422,781,26705,6851,SX128x_Transmit_Interrupt
23794,380,757,24931,6163,Si443x_Receive_Blocking
23884,380,758,25022,61be,Si443x_Receive_Interrupt
23866,384,1099,25349,6305,Si443x_Settings
23978,394,759,25131,622b,Si443x_Transmit_Blocking
24062,408,762,25232,6290,Si443x_Transmit_Interrupt
33256,392,1285,34933,8875,Stream_Receive
33658,906,783,35347,8a13,Stream_Transmit
17346,382,746,18474,482a,nRF24_Receive_Blocking
17448,382,747,18577,4891,nRF24_Receive_Interrupt
17682,398,748,18828,498c,nRF24_Transmit_Blocking
17758,410,751,18919,49e7,nRF24_Transmit_Interrupt
