text,data,bss,dec,hex,filename
44448,844,3508,48800,bea0,AFSK_Imperial_March
44216,156,3508,47880,bb08,AFSK_Tone
44312,156,3508,47976,bb68,AFSK_Tone_AM
49884,156,3564,53604,d164,APRS_MicE
49592,156,3564,53312,d040,APRS_Position
49532,156,3532,53220,cfe4,APRS_Position_LoRa
46004,156,3524,49684,c214,AX25_Frames
45628,156,3524,49308,c09c,AX25_Transmit
46144,156,3532,49832,c2a8,AX25_Transmit_AFSK
46888,156,3540,50584,c598,BellModem_Transmit
35408,156,3484,39048,9888,CC1101_Receive_Address
35272,156,3484,38912,9800,CC1101_Receive_Blocking
35348,156,3492,38996,9854,CC1101_Receive_Interrupt
34840,156,3844,38840,97b8,CC1101_Settings
34348,156,3484,37988,9464,CC1101_Transmit_Address
34884,156,3492,38532,9684,CC1101_Transmit_Blocking
35024,156,3500,38680,9718,CC1101_Transmit_Interrupt
44872,208,3560,48640,be00,FSK4_Transmit
44896,208,3568,48672,be20,FSK4_Transmit_AFSK
47164,156,3540,50860,c6ac,Hellschreiber_Transmit
47236,156,3548,50940,c6fc,Hellschreiber_Transmit_AFSK
42008,156,3532,45696,b280,LR11x0_Channel_Activity_Detection_Blocking
42184,156,3532,45872,b330,LR11x0_Channel_Activity_Detection_Interrupt
43004,156,3532,46692,b664,LR11x0_GFSK_Modem
43904,156,3612,47672,ba38,LR11x0_GNSS_Almanac_Update
43884,156,3548,47588,b9e4,LR11x0_GNSS_Autonomous_Position
43460,156,3532,47148,b82c,LR11x0_GNSS_Satellites
41732,156,3532,45420,b16c,LR11x0_LR_FHSS_Modem
43300,156,3540,46996,b794,LR11x0_PingPong
43072,156,3532,46760,b6a8,LR11x0_Receive_Blocking
43136,156,3532,46824,b6e8,LR11x0_Receive_Interrupt
43168,156,3532,46856,b708,LR11x0_Transmit_Blocking
42856,156,3540,46552,b5d8,LR11x0_Transmit_Interrupt
44132,156,3532,47820,bacc,LR11x0_WiFi_Scan_Blocking
44188,156,3532,47876,bb04,LR11x0_WiFi_Scan_Interrupt
62156,156,5008,67320,106f8,LoRaWAN_ABP
64628,156,5096,69880,110f8,LoRaWAN_Class_C
64716,156,5104,69976,11158,LoRaWAN_Multicast
64012,156,5024,69192,10e48,LoRaWAN_Reference
62056,156,5024,67236,106a4,LoRaWAN_Starter
65036,164,5544,70744,11458,LoRaWAN_TS_Packages
45608,156,3580,49344,c0c0,Morse_Receive_AM
47308,156,3572,51036,c75c,Morse_Transmit_AM
47220,156,3572,50948,c704,Morse_Transmit_FM
47196,156,3564,50916,c6e4,Morse_Transmit_SSB
46732,160,3552,50444,c50c,Pager_Receive
46580,156,3556,50292,c474,Pager_Transmit
45584,160,3504,49248,c060,PhysicalLayer_Interface
36284,156,3492,39932,9bfc,RF69_Receive_AES
36500,156,3492,40148,9cd4,RF69_Receive_Address
36592,156,3492,40240,9d30,RF69_Receive_Blocking
36660,156,3492,40308,9d74,RF69_Receive_Interrupt
36644,156,3852,40652,9ecc,RF69_Settings
35716,156,3492,39364,99c4,RF69_Transmit_AES
35932,156,3492,39580,9a9c,RF69_Transmit_Address
36304,156,3492,39952,9c10,RF69_Transmit_Blocking
36444,156,3500,40100,9ca4,RF69_Transmit_Interrupt
47080,156,3548,50784,c660,RTTY_Transmit
47096,156,3556,50808,c678,RTTY_Transmit_AFSK
45712,1436,3636,50784,c660,SSTV_Transmit
45744,1436,3644,50824,c688,SSTV_Transmit_AFSK
47092,156,3572,50820,c684,STM32WLx_Channel_Activity_Detection
47276,156,3580,51012,c744,STM32WLx_Channel_Activity_Detection_Interrupt
48204,156,3572,51932,cadc,STM32WLx_Receive_Blocking
48272,156,3580,52008,cb28,STM32WLx_Receive_Interrupt
48300,156,3580,52036,cb44,STM32WLx_Transmit_Blocking
47992,156,3588,51736,ca18,STM32WLx_Transmit_Interrupt
36360,156,3492,40008,9c48,SX123x_Receive_Blocking
36456,156,3500,40112,9cb0,SX123x_Transmit_Blocking
45432,156,3572,49160,c008,SX126x_Channel_Activity_Detection_Blocking
45612,156,3580,49348,c0c4,SX126x_Channel_Activity_Detection_Interrupt
47116,156,3580,50852,c6a4,SX126x_Channel_Activity_Detection_Receive
46584,156,3572,50312,c488,SX126x_FSK_Modem
46576,156,3580,50312,c488,SX126x_LR_FHSS_Transmit_Blocking
46292,156,3588,50036,c374,SX126x_LR_FHSS_Transmit_Interrupt
46724,156,3580,50460,c51c,SX126x_PingPong
46756,156,3572,50484,c534,SX126x_Receive_Blocking
46820,156,3580,50556,c57c,SX126x_Receive_Interrupt
47276,156,4020,51452,c8fc,SX126x_Settings
47544,156,3572,51272,c848,SX126x_Spectrum_Scan
48012,156,3572,51740,ca1c,SX126x_Spectrum_Scan_Frequency
46588,156,3580,50324,c494,SX126x_Transmit_Blocking
46280,156,3588,50024,c368,SX126x_Transmit_Interrupt
44000,156,3500,47656,ba28,SX127x_Channel_Activity_Detection_Blocking
44172,156,3508,47836,badc,SX127x_Channel_Activity_Detection_Interrupt
45828,156,3508,49492,c154,SX127x_Channel_Activity_Detection_Receive
45716,156,3500,49372,c0dc,SX127x_FSK_Modem
45316,156,3508,48980,bf54,SX127x_PingPong
45456,156,3500,49112,bfd8,SX127x_Receive_Blocking
44164,156,3500,47820,bacc,SX127x_Receive_Direct
45124,184,3512,48820,beb4,SX127x_Receive_FHSS
45552,156,3508,49216,c040,SX127x_Receive_Interrupt
47808,156,3876,51840,ca80,SX127x_Settings
45180,156,3508,48844,becc,SX127x_Transmit_Blocking
45596,184,3528,49308,c09c,SX127x_Transmit_FHSS
44868,156,3516,48540,bd9c,SX127x_Transmit_Interrupt
39036,156,3508,42700,a6cc,SX128x_BLE_Modem
37744,156,3508,41408,a1c0,SX128x_Channel_Activity_Detection_Blocking
37924,156,3508,41588,a274,SX128x_Channel_Activity_Detection_Interrupt
39040,156,3508,42704,a6d0,SX128x_FLRC_Modem
38768,156,3508,42432,a5c0,SX128x_GFSK_Modem
39076,156,3508,42740,a6f4,SX128x_Ranging
39064,156,3508,42728,a6e8,SX128x_Receive_Blocking
39140,156,3508,42804,a734,SX128x_Receive_Interrupt
38604,156,3884,42644,a694,SX128x_Settings
38444,156,3508,42108,a47c,SX128x_Transmit_Blocking
38584,156,3516,42256,a510,SX128x_Transmit_Interrupt
37176,156,3484,40816,9f70,Si443x_Receive_Blocking
37248,156,3484,40888,9fb8,Si443x_Receive_Interrupt
37320,156,3836,41312,a160,Si443x_Settings
37320,156,3484,40960,a000,Si443x_Transmit_Blocking
37436,156,3492,41084,a07c,Si443x_Transmit_Interrupt
44272,156,4028,48456,bd48,Stream_Receive
45144,156,3532,48832,bec0,Stream_Transmit
31236,156,3468,34860,882c,nRF24_Receive_Blocking
31324,156,3476,34956,888c,nRF24_Receive_Interrupt
31396,156,3476,35028,88d4,nRF24_Transmit_Blocking
31480,156,3484,35120,8930,nRF24_Transmit_Interrupt
