text,data,bss,dec,hex,filename
32860,690,773,34323,8613,AFSK_Imperial_March
32600,346,773,33719,83b7,AFSK_Tone
32732,346,773,33851,843b,AFSK_Tone_AM
37602,396,808,38806,9796,APRS_MicE
38428,494,808,39730,9b32,APRS_Position
37142,432,786,38360,95d8,APRS_Position_LoRa
34782,408,783,35973,8c85,AX25_Frames
34370,370,783,35523,8ac3,AX25_Transmit
35218,388,789,36395,8e2b,AX25_Transmit_AFSK
35360,416,796,36572,8edc,BellModem_Transmit
21786,384,757,22927,598f,CC1101_Receive_Address
21666,384,757,22807,5917,CC1101_Receive_Blocking
21762,384,758,22904,5978,CC1101_Receive_Interrupt
21820,372,1101,23293,5afd,CC1101_Settings
20478,384,757,21619,5473,CC1101_Transmit_Address
21418,386,759,22563,5823,CC1101_Transmit_Blocking
21520,400,762,22682,589a,CC1101_Transmit_Interrupt
33536,392,823,34751,87bf,FSK4_Transmit
33562,392,829,34783,87df,FSK4_Transmit_AFSK
35738,392,789,36919,9037,Hellschreiber_Transmit
35838,408,795,37041,90b1,Hellschreiber_Transmit_AFSK
26542,564,795,27901,6cfd,LR11x0_Channel_Activity_Detection_Blocking
26782,564,796,28142,6dee,LR11x0_Channel_Activity_Detection_Interrupt
28090,396,795,29281,7261,LR11x0_GFSK_Modem
27402,564,860,28826,709a,LR11x0_GNSS_Almanac_Update
28434,580,810,29824,7480,LR11x0_GNSS_Autonomous_Position
28284,572,799,29655,73d7,LR11x0_GNSS_Satellites
26478,392,795,27665,6c11,LR11x0_LR_FHSS_Modem
28196,588,799,29583,738f,LR11x0_PingPong
28036,576,795,29407,72df,LR11x0_Receive_Blocking
28122,576,796,29494,7336,LR11x0_Receive_Interrupt
27954,590,797,29341,729d,LR11x0_Transmit_Blocking
27660,592,800,29052,717c,LR11x0_Transmit_Interrupt
29932,598,795,31325,7a5d,LR11x0_WiFi_Scan_Blocking
30052,598,796,31446,7ad6,LR11x0_WiFi_Scan_Interrupt
59114,1756,1993,62863,f58f,LoRaWAN_ABP
61474,1788,1991,65253,fee5,LoRaWAN_Reference
59124,1756,1991,62871,f597,LoRaWAN_Starter
34792,356,826,35974,8c86,Morse_Receive_AM
35860,384,824,37068,90cc,Morse_Transmit_AM
35722,384,824,36930,9042,Morse_Transmit_FM
35698,384,818,36900,9024,Morse_Transmit_SSB
38446,358,806,39610,9aba,Pager_Receive
38478,376,804,39658,9aea,Pager_Transmit
34250,372,767,35389,8a3d,PhysicalLayer_Interface
21528,348,761,22637,586d,RF69_Receive_AES
21794,332,761,22887,5967,RF69_Receive_Address
21836,344,761,22941,599d,RF69_Receive_Blocking
21914,344,762,23020,59ec,RF69_Receive_Interrupt
22378,340,1109,23827,5d13,RF69_Settings
20668,360,761,21789,551d,RF69_Transmit_AES
20932,344,761,22037,5615,RF69_Transmit_Address
21638,346,763,22747,58db,RF69_Transmit_Blocking
21744,360,766,22870,5956,RF69_Transmit_Interrupt
35840,382,797,37019,909b,RTTY_Transmit
35864,382,803,37049,90b9,RTTY_Transmit_AFSK
34608,1706,859,37173,9135,SSTV_Transmit
34656,1706,865,37227,916b,SSTV_Transmit_AFSK
21610,334,762,22706,58b2,SX123x_Receive_Blocking
21672,348,764,22784,5900,SX123x_Transmit_Blocking
36968,588,823,38379,95eb,SX126x_Channel_Activity_Detection_Blocking
37192,588,824,38604,96cc,SX126x_Channel_Activity_Detection_Interrupt
39112,600,825,40537,9e59,SX126x_Channel_Activity_Detection_Receive
38424,610,823,39857,9bb1,SX126x_FSK_Modem
38356,616,825,39797,9b75,SX126x_LR_FHSS_Transmit_Blocking
38010,616,828,39454,9a1e,SX126x_LR_FHSS_Transmit_Interrupt
38556,614,827,39997,9c3d,SX126x_PingPong
38664,600,823,40087,9c97,SX126x_Receive_Blocking
38748,600,824,40172,9cec,SX126x_Receive_Interrupt
39840,832,1231,41903,a3af,SX126x_Settings
39330,600,823,40753,9f31,SX126x_Spectrum_Scan
39770,618,823,41211,a0fb,SX126x_Spectrum_Scan_Frequency
38382,616,825,39823,9b8f,SX126x_Transmit_Blocking
38092,616,828,39536,9a70,SX126x_Transmit_Interrupt
32208,346,767,33321,8229,SX127x_Channel_Activity_Detection_Blocking
32564,346,769,33679,838f,SX127x_Channel_Activity_Detection_Interrupt
34590,358,770,35718,8b86,SX127x_Channel_Activity_Detection_Receive
34428,368,767,35563,8aeb,SX127x_FSK_Modem
33896,372,771,35039,88df,SX127x_PingPong
34118,358,767,35243,89ab,SX127x_Receive_Blocking
32282,388,767,33437,829d,SX127x_Receive_Direct
33802,370,771,34943,887f,SX127x_Receive_FHSS
34216,358,768,35342,8a0e,SX127x_Receive_Interrupt
37518,464,1121,39103,98bf,SX127x_Settings
33714,374,769,34857,8829,SX127x_Transmit_Blocking
34420,592,781,35793,8bd1,SX127x_Transmit_FHSS
33422,374,772,34568,8708,SX127x_Transmit_Interrupt
25050,360,773,26183,6647,SX128x_BLE_Modem
23390,348,773,24511,5fbf,SX128x_Channel_Activity_Detection_Blocking
23620,348,774,24742,60a6,SX128x_Channel_Activity_Detection_Interrupt
25140,368,773,26281,66a9,SX128x_FLRC_Modem
24754,366,773,25893,6525,SX128x_GFSK_Modem
25518,396,773,26687,683f,SX128x_Ranging
25888,360,773,27021,698d,SX128x_Receive_Blocking
25984,360,774,27118,69ee,SX128x_Receive_Interrupt
24946,348,1133,26427,673b,SX128x_Settings
24418,362,775,25555,63d3,SX128x_Transmit_Blocking
24526,376,778,25680,6450,SX128x_Transmit_Interrupt
23510,334,754,24598,6016,Si443x_Receive_Blocking
23600,334,755,24689,6071,Si443x_Receive_Interrupt
23694,338,1095,25127,6227,Si443x_Settings
23694,348,756,24798,60de,Si443x_Transmit_Blocking
23778,362,759,24899,6143,Si443x_Transmit_Interrupt
32878,346,1283,34507,86cb,Stream_Receive
33394,860,781,35035,88db,Stream_Transmit
17208,336,744,18288,4770,nRF24_Receive_Blocking
17310,336,745,18391,47d7,nRF24_Receive_Interrupt
17544,352,746,18642,48d2,nRF24_Transmit_Blocking
17620,364,749,18733,492d,nRF24_Transmit_Interrupt
