text,data,bss,dec,hex,filename
33112,736,775,34623,873f,AFSK_Imperial_March
32852,392,775,34019,84e3,AFSK_Tone
32984,392,775,34151,8567,AFSK_Tone_AM
37872,442,810,39124,98d4,APRS_MicE
38698,540,810,40048,9c70,APRS_Position
37384,478,788,38650,96fa,APRS_Position_LoRa
35026,454,785,36265,8da9,AX25_Frames
34614,416,785,35815,8be7,AX25_Transmit
35468,434,791,36693,8f55,AX25_Transmit_AFSK
35642,462,798,36902,9026,BellModem_Transmit
22410,430,759,23599,5c2f,CC1101_Receive_Address
22290,430,759,23479,5bb7,CC1101_Receive_Blocking
22386,430,760,23576,5c18,CC1101_Receive_Interrupt
22326,418,1103,23847,5d27,CC1101_Settings
21102,430,759,22291,5713,CC1101_Transmit_Address
22042,432,761,23235,5ac3,CC1101_Transmit_Blocking
22144,446,764,23354,5b3a,CC1101_Transmit_Interrupt
33802,438,825,35065,88f9,FSK4_Transmit
33838,438,831,35107,8923,FSK4_Transmit_AFSK
36000,438,791,37229,916d,Hellschreiber_Transmit
36112,454,797,37363,91f3,Hellschreiber_Transmit_AFSK
26760,610,797,28167,6e07,LR11x0_Channel_Activity_Detection_Blocking
27000,610,798,28408,6ef8,LR11x0_Channel_Activity_Detection_Interrupt
28308,442,797,29547,736b,LR11x0_GFSK_Modem
27620,610,862,29092,71a4,LR11x0_GNSS_Almanac_Update
28660,626,812,30098,7592,LR11x0_GNSS_Autonomous_Position
28502,618,801,29921,74e1,LR11x0_GNSS_Satellites
26696,438,797,27931,6d1b,LR11x0_LR_FHSS_Modem
28414,634,801,29849,7499,LR11x0_PingPong
28254,622,797,29673,73e9,LR11x0_Receive_Blocking
28340,622,798,29760,7440,LR11x0_Receive_Interrupt
28172,636,799,29607,73a7,LR11x0_Transmit_Blocking
27878,638,802,29318,7286,LR11x0_Transmit_Interrupt
30150,644,797,31591,7b67,LR11x0_WiFi_Scan_Blocking
30270,644,798,31712,7be0,LR11x0_WiFi_Scan_Interrupt
59386,1802,1995,63183,f6cf,LoRaWAN_ABP
61746,1834,1993,65573,10025,LoRaWAN_Reference
59396,1802,1993,63191,f6d7,LoRaWAN_Starter
35124,402,828,36354,8e02,Morse_Receive_AM
36192,430,826,37448,9248,Morse_Transmit_AM
36054,430,826,37310,91be,Morse_Transmit_FM
36018,430,820,37268,9194,Morse_Transmit_SSB
38750,404,808,39962,9c1a,Pager_Receive
38774,422,806,40002,9c42,Pager_Transmit
34494,418,769,35681,8b61,PhysicalLayer_Interface
21670,394,763,22827,592b,RF69_Receive_AES
21936,378,763,23077,5a25,RF69_Receive_Address
21978,390,763,23131,5a5b,RF69_Receive_Blocking
22056,390,764,23210,5aaa,RF69_Receive_Interrupt
22402,386,1111,23899,5d5b,RF69_Settings
20810,406,763,21979,55db,RF69_Transmit_AES
21074,390,763,22227,56d3,RF69_Transmit_Address
21780,392,765,22937,5999,RF69_Transmit_Blocking
21886,406,768,23060,5a14,RF69_Transmit_Interrupt
36128,428,799,37355,91eb,RTTY_Transmit
36164,428,805,37397,9215,RTTY_Transmit_AFSK
34914,1752,861,37527,9297,SSTV_Transmit
34970,1752,867,37589,92d5,SSTV_Transmit_AFSK
21752,380,764,22896,5970,SX123x_Receive_Blocking
21814,394,766,22974,59be,SX123x_Transmit_Blocking
37192,634,825,38651,96fb,SX126x_Channel_Activity_Detection_Blocking
37416,634,826,38876,97dc,SX126x_Channel_Activity_Detection_Interrupt
39336,646,827,40809,9f69,SX126x_Channel_Activity_Detection_Receive
38648,656,825,40129,9cc1,SX126x_FSK_Modem
38580,662,827,40069,9c85,SX126x_LR_FHSS_Transmit_Blocking
38234,662,830,39726,9b2e,SX126x_LR_FHSS_Transmit_Interrupt
38780,660,829,40269,9d4d,SX126x_PingPong
38888,646,825,40359,9da7,SX126x_Receive_Blocking
38972,646,826,40444,9dfc,SX126x_Receive_Interrupt
39868,878,1233,41979,a3fb,SX126x_Settings
39554,646,825,41025,a041,SX126x_Spectrum_Scan
39994,664,825,41483,a20b,SX126x_Spectrum_Scan_Frequency
38606,662,827,40095,9c9f,SX126x_Transmit_Blocking
38316,662,830,39808,9b80,SX126x_Transmit_Interrupt
32452,392,769,33613,834d,SX127x_Channel_Activity_Detection_Blocking
32808,392,771,33971,84b3,SX127x_Channel_Activity_Detection_Interrupt
34834,404,772,36010,8caa,SX127x_Channel_Activity_Detection_Receive
34672,414,769,35855,8c0f,SX127x_FSK_Modem
34140,418,773,35331,8a03,SX127x_PingPong
34362,404,769,35535,8acf,SX127x_Receive_Blocking
32526,434,769,33729,83c1,SX127x_Receive_Direct
34046,416,773,35235,89a3,SX127x_Receive_FHSS
34460,404,770,35634,8b32,SX127x_Receive_Interrupt
37742,618,1123,39483,9a3b,SX127x_Settings
33958,420,771,35149,894d,SX127x_Transmit_Blocking
34550,638,783,35971,8c83,SX127x_Transmit_FHSS
33666,420,774,34860,882c,SX127x_Transmit_Interrupt
25310,406,776,26492,677c,SX128x_BLE_Modem
23650,394,776,24820,60f4,SX128x_Channel_Activity_Detection_Blocking
23880,394,777,25051,61db,SX128x_Channel_Activity_Detection_Interrupt
25422,414,776,26612,67f4,SX128x_FLRC_Modem
25036,412,776,26224,6670,SX128x_GFSK_Modem
25778,442,776,26996,6974,SX128x_Ranging
26148,406,776,27330,6ac2,SX128x_Receive_Blocking
26244,406,777,27427,6b23,SX128x_Receive_Interrupt
25050,502,1137,26689,6841,SX128x_Settings
24678,408,778,25864,6508,SX128x_Transmit_Blocking
24786,422,781,25989,6585,SX128x_Transmit_Interrupt
23650,380,756,24786,60d2,Si443x_Receive_Blocking
23740,380,757,24877,612d,Si443x_Receive_Interrupt
23722,384,1097,25203,6273,Si443x_Settings
23834,394,758,24986,619a,Si443x_Transmit_Blocking
23918,408,761,25087,61ff,Si443x_Transmit_Interrupt
33122,392,1285,34799,87ef,Stream_Receive
33524,906,783,35213,898d,Stream_Transmit
17346,382,746,18474,482a,nRF24_Receive_Blocking
17448,382,747,18577,4891,nRF24_Receive_Interrupt
17682,398,748,18828,498c,nRF24_Transmit_Blocking
17758,410,751,18919,49e7,nRF24_Transmit_Interrupt
