text,data,bss,dec,hex,filename
30754,100,895,31749,7c05,AFSK_Imperial_March
30156,100,895,31151,79af,AFSK_Tone
30330,100,895,31325,7a5d,AFSK_Tone_AM
35263,100,930,36293,8dc5,APRS_MicE
36121,100,930,37151,911f,APRS_Position
34658,100,908,35666,8b52,APRS_Position_LoRa
32499,100,905,33504,82e0,AX25_Frames
31812,100,905,32817,8031,AX25_Transmit
32622,100,911,33633,8361,AX25_Transmit_AFSK
33035,100,918,34053,8505,BellModem_Transmit
20299,100,880,21279,531f,CC1101_Receive_Address
20181,100,880,21161,52a9,CC1101_Receive_Blocking
20261,100,881,21242,52fa,CC1101_Receive_Interrupt
20133,100,1222,21455,53cf,CC1101_Settings
18954,100,880,19934,4dde,CC1101_Transmit_Address
19872,100,882,20854,5176,CC1101_Transmit_Blocking
19985,100,885,20970,51ea,CC1101_Transmit_Interrupt
31130,146,945,32221,7ddd,FSK4_Transmit
31166,146,951,32263,7e07,FSK4_Transmit_AFSK
33375,100,911,34386,8652,Hellschreiber_Transmit
33493,100,917,34510,86ce,Hellschreiber_Transmit_AFSK
24947,100,914,25961,6569,LR11x0_Channel_Activity_Detection_Blocking
25171,100,915,26186,664a,LR11x0_Channel_Activity_Detection_Interrupt
26332,100,914,27346,6ad2,LR11x0_GFSK_Modem
25781,100,979,26860,68ec,LR11x0_GNSS_Almanac_Update
26834,100,929,27863,6cd7,LR11x0_GNSS_Autonomous_Position
26712,100,918,27730,6c52,LR11x0_GNSS_Satellites
24714,100,914,25728,6480,LR11x0_LR_FHSS_Modem
26596,100,918,27614,6bde,LR11x0_PingPong
26433,100,914,27447,6b37,LR11x0_Receive_Blocking
26513,100,915,27528,6b88,LR11x0_Receive_Interrupt
26346,100,916,27362,6ae2,LR11x0_Transmit_Blocking
26083,100,919,27102,69de,LR11x0_Transmit_Interrupt
28317,100,914,29331,7293,LR11x0_WiFi_Scan_Blocking
28423,100,915,29438,72fe,LR11x0_WiFi_Scan_Interrupt
32460,100,948,33508,82e4,Morse_Receive_AM
33602,100,946,34648,8758,Morse_Transmit_AM
33424,100,946,34470,86a6,Morse_Transmit_FM
33388,100,940,34428,867c,Morse_Transmit_SSB
36029,104,928,37061,90c5,Pager_Receive
35984,100,926,37010,9092,Pager_Transmit
31731,100,889,32720,7fd0,PhysicalLayer_Interface
20027,100,884,21011,5213,RF69_Receive_AES
20275,100,884,21259,530b,RF69_Receive_Address
20297,100,884,21281,5321,RF69_Receive_Blocking
20359,100,885,21344,5360,RF69_Receive_Interrupt
20611,100,1230,21941,55b5,RF69_Settings
19100,100,884,20084,4e74,RF69_Transmit_AES
19348,100,884,20332,4f6c,RF69_Transmit_Address
20008,100,886,20994,5202,RF69_Transmit_Blocking
20123,100,889,21112,5278,RF69_Transmit_Interrupt
33462,100,919,34481,86b1,RTTY_Transmit
33498,100,925,34523,86db,RTTY_Transmit_AFSK
32146,1380,981,34507,86cb,SSTV_Transmit
32210,1380,987,34577,8711,SSTV_Transmit_AFSK
19765,100,885,20750,510e,SX123x_Receive_Blocking
19742,100,887,20729,50f9,SX123x_Transmit_Blocking
33404,100,942,34446,868e,SX126x_Channel_Activity_Detection_Blocking
33622,100,943,34665,8769,SX126x_Channel_Activity_Detection_Interrupt
35660,100,944,36704,8f60,SX126x_Channel_Activity_Detection_Receive
35027,100,942,36069,8ce5,SX126x_FSK_Modem
33641,100,942,34683,877b,SX126x_LR_FHSS_Modem
35125,100,946,36171,8d4b,SX126x_PingPong
35210,100,942,36252,8d9c,SX126x_Receive_Blocking
35294,100,943,36337,8df1,SX126x_Receive_Interrupt
36065,100,1344,37509,9285,SX126x_Settings
35975,100,942,37017,9099,SX126x_Spectrum_Scan
36401,100,942,37443,9243,SX126x_Spectrum_Scan_Frequency
34833,100,944,35877,8c25,SX126x_Transmit_Blocking
34580,100,947,35627,8b2b,SX126x_Transmit_Interrupt
29646,100,889,30635,77ab,SX127x_Channel_Activity_Detection_Blocking
29986,100,891,30977,7901,SX127x_Channel_Activity_Detection_Interrupt
32068,100,892,33060,8124,SX127x_Channel_Activity_Detection_Receive
32149,100,889,33138,8172,SX127x_FSK_Modem
31413,100,893,32406,7e96,SX127x_PingPong
31606,100,889,32595,7f53,SX127x_Receive_Blocking
29947,100,889,30936,78d8,SX127x_Receive_Direct
31350,100,893,32343,7e57,SX127x_Receive_FHSS
31700,100,890,32690,7fb2,SX127x_Receive_Interrupt
34794,100,1240,36134,8d26,SX127x_Settings
31107,100,891,32098,7d62,SX127x_Transmit_Blocking
31959,100,903,32962,80c2,SX127x_Transmit_FHSS
30858,100,894,31852,7c6c,SX127x_Transmit_Interrupt
23186,100,892,24178,5e72,SX128x_BLE_Modem
21477,100,892,22469,57c5,SX128x_Channel_Activity_Detection_Blocking
21697,100,893,22690,58a2,SX128x_Channel_Activity_Detection_Interrupt
23296,100,892,24288,5ee0,SX128x_FLRC_Modem
22901,100,892,23893,5d55,SX128x_GFSK_Modem
23611,100,892,24603,601b,SX128x_Ranging
24075,100,892,25067,61eb,SX128x_Receive_Blocking
24165,100,893,25158,6246,SX128x_Receive_Interrupt
22815,100,1246,24161,5e61,SX128x_Settings
22518,100,894,23512,5bd8,SX128x_Transmit_Blocking
22637,100,897,23634,5c52,SX128x_Transmit_Interrupt
20673,100,877,21650,5492,Si443x_Receive_Blocking
20751,100,878,21729,54e1,Si443x_Receive_Interrupt
21911,100,1216,23227,5abb,Si443x_Settings
20780,100,879,21759,54ff,Si443x_Transmit_Blocking
20873,100,882,21855,555f,Si443x_Transmit_Interrupt
30284,100,1405,31789,7c2d,Stream_Receive
31347,100,903,32350,7e5e,Stream_Transmit
15884,100,867,16851,41d3,nRF24_Receive_Blocking
15968,100,868,16936,4228,nRF24_Receive_Interrupt
16125,100,869,17094,42c6,nRF24_Transmit_Blocking
16210,100,872,17182,431e,nRF24_Transmit_Interrupt
