text,data,bss,dec,hex,filename
39836,1960,1736,43532,aa0c,AFSK_Imperial_March
39628,1272,1736,42636,a68c,AFSK_Tone
39716,1272,1736,42724,a6e4,AFSK_Tone_AM
45168,1272,1792,48232,bc68,APRS_MicE
44832,1272,1792,47896,bb18,APRS_Position
44784,1272,1760,47816,bac8,APRS_Position_LoRa
41396,1272,1752,44420,ad84,AX25_Frames
41028,1272,1752,44052,ac14,AX25_Transmit
41532,1272,1760,44564,ae14,AX25_Transmit_AFSK
42276,1272,1768,45316,b104,BellModem_Transmit
32892,1272,1712,35876,8c24,CC1101_Receive_Address
32756,1272,1712,35740,8b9c,CC1101_Receive_Blocking
32820,1272,1712,35804,8bdc,CC1101_Receive_Interrupt
29828,1272,2072,33172,8194,CC1101_Settings
29316,1272,1712,32300,7e2c,CC1101_Transmit_Address
29852,1272,1712,32836,8044,CC1101_Transmit_Blocking
29980,1272,1720,32972,80cc,CC1101_Transmit_Interrupt
40244,1328,1792,43364,a964,FSK4_Transmit
40276,1328,1800,43404,a98c,FSK4_Transmit_AFSK
42540,1272,1768,45580,b20c,Hellschreiber_Transmit
42620,1272,1776,45668,b264,Hellschreiber_Transmit_AFSK
38532,1272,1752,41556,a254,LR11x0_Channel_Activity_Detection_Blocking
38700,1272,1760,41732,a304,LR11x0_Channel_Activity_Detection_Interrupt
39524,1272,1752,42548,a634,LR11x0_GFSK_Modem
40652,1272,1832,43756,aaec,LR11x0_GNSS_Almanac_Update
40692,1272,1768,43732,aad4,LR11x0_GNSS_Autonomous_Position
40004,1272,1760,43036,a81c,LR11x0_GNSS_Satellites
38252,1272,1752,41276,a13c,LR11x0_LR_FHSS_Modem
40060,1272,1760,43092,a854,LR11x0_PingPong
39820,1272,1752,42844,a75c,LR11x0_Receive_Blocking
39884,1272,1760,42916,a7a4,LR11x0_Receive_Interrupt
39900,1272,1760,42932,a7b4,LR11x0_Transmit_Blocking
39356,1272,1768,42396,a59c,LR11x0_Transmit_Interrupt
41044,1272,1752,44068,ac24,LR11x0_WiFi_Scan_Blocking
41124,1272,1760,44156,ac7c,LR11x0_WiFi_Scan_Interrupt
58180,1272,3624,63076,f664,LoRaWAN_ABP
62516,1272,3712,67500,107ac,LoRaWAN_Class_C
62628,1272,3720,67620,10824,LoRaWAN_Multicast
60444,1272,3640,65356,ff4c,LoRaWAN_Reference
58124,1272,3640,63036,f63c,LoRaWAN_Starter
61280,1280,4168,66728,104a8,LoRaWAN_TS_Packages
41056,1280,1808,44144,ac70,Morse_Receive_AM
42704,1280,1800,45784,b2d8,Morse_Transmit_AM
42608,1280,1800,45688,b278,Morse_Transmit_FM
42576,1280,1792,45648,b250,Morse_Transmit_SSB
42244,1280,1784,45308,b0fc,Pager_Receive
42108,1272,1784,45164,b06c,Pager_Transmit
41260,1280,1728,44268,acec,PhysicalLayer_Interface
31268,1272,1712,34252,85cc,RF69_Receive_AES
31460,1272,1712,34444,868c,RF69_Receive_Address
32124,1272,1712,35108,8924,RF69_Receive_Blocking
32188,1272,1720,35180,896c,RF69_Receive_Interrupt
31628,1272,2080,34980,88a4,RF69_Settings
30676,1272,1712,33660,837c,RF69_Transmit_AES
30892,1272,1712,33876,8454,RF69_Transmit_Address
31244,1272,1720,34236,85bc,RF69_Transmit_Blocking
31380,1272,1728,34380,864c,RF69_Transmit_Interrupt
42492,1272,1776,45540,b1e4,RTTY_Transmit
42524,1272,1784,45580,b20c,RTTY_Transmit_AFSK
41116,2552,1864,45532,b1dc,SSTV_Transmit
41164,2552,1872,45588,b214,SSTV_Transmit_AFSK
31380,1272,1720,34372,8644,SX123x_Receive_Blocking
31452,1272,1720,34444,868c,SX123x_Transmit_Blocking
42404,1272,1800,45476,b1a4,SX126x_Channel_Activity_Detection_Blocking
42588,1272,1800,45660,b25c,SX126x_Channel_Activity_Detection_Interrupt
44316,1272,1800,47388,b91c,SX126x_Channel_Activity_Detection_Receive
43572,1272,1800,46644,b634,SX126x_FSK_Modem
43748,1272,1800,46820,b6e4,SX126x_LR_FHSS_Transmit_Blocking
43236,1272,1808,46316,b4ec,SX126x_LR_FHSS_Transmit_Interrupt
43932,1272,1808,47012,b7a4,SX126x_PingPong
43988,1272,1800,47060,b7d4,SX126x_Receive_Blocking
44044,1272,1800,47116,b80c,SX126x_Receive_Interrupt
44380,1272,2248,47900,bb1c,SX126x_Settings
44540,1272,1800,47612,b9fc,SX126x_Spectrum_Scan
45244,1272,1800,48316,bcbc,SX126x_Spectrum_Scan_Frequency
43764,1272,1800,46836,b6f4,SX126x_Transmit_Blocking
43236,1272,1808,46316,b4ec,SX126x_Transmit_Interrupt
39412,1272,1728,42412,a5ac,SX127x_Channel_Activity_Detection_Blocking
39588,1272,1736,42596,a664,SX127x_Channel_Activity_Detection_Interrupt
41492,1272,1736,44500,add4,SX127x_Channel_Activity_Detection_Receive
41124,1272,1728,44124,ac5c,SX127x_FSK_Modem
40956,1272,1736,43964,abbc,SX127x_PingPong
41132,1272,1728,44132,ac64,SX127x_Receive_Blocking
39580,1272,1728,42580,a654,SX127x_Receive_Direct
40556,1304,1736,43596,aa4c,SX127x_Receive_FHSS
41228,1272,1736,44236,accc,SX127x_Receive_Interrupt
43444,1272,2112,46828,b6ec,SX127x_Settings
40788,1272,1736,43796,ab14,SX127x_Transmit_Blocking
40972,1304,1760,44036,ac04,SX127x_Transmit_FHSS
40260,1272,1744,43276,a90c,SX127x_Transmit_Interrupt
34748,1272,1736,37756,937c,SX128x_BLE_Modem
33436,1272,1736,36444,8e5c,SX128x_Channel_Activity_Detection_Blocking
33604,1272,1736,36612,8f04,SX128x_Channel_Activity_Detection_Interrupt
34740,1272,1736,37748,9374,SX128x_FLRC_Modem
34452,1272,1736,37460,9254,SX128x_GFSK_Modem
35332,1272,1736,38340,95c4,SX128x_Ranging
35340,1272,1736,38348,95cc,SX128x_Receive_Blocking
35412,1272,1736,38420,9614,SX128x_Receive_Interrupt
34348,1272,2120,37740,936c,SX128x_Settings
34116,1272,1736,37124,9104,SX128x_Transmit_Blocking
34244,1272,1744,37260,918c,SX128x_Transmit_Interrupt
32292,1272,1704,35268,89c4,Si443x_Receive_Blocking
32364,1272,1712,35348,8a14,Si443x_Receive_Interrupt
32460,1272,2064,35796,8bd4,Si443x_Settings
32412,1272,1712,35396,8a44,Si443x_Transmit_Blocking
32524,1272,1720,35516,8abc,Si443x_Transmit_Interrupt
39692,1272,2248,43212,a8cc,Stream_Receive
40548,1272,1760,43580,aa3c,Stream_Transmit
26276,1272,1696,29244,723c,nRF24_Receive_Blocking
26348,1272,1696,29316,7284,nRF24_Receive_Interrupt
26388,1272,1696,29356,72ac,nRF24_Transmit_Blocking
26476,1272,1704,29452,730c,nRF24_Transmit_Interrupt
