text,data,bss,dec,hex,filename
223201,101520,6097,330818,50c42,AFSK_Imperial_March
223069,100832,6097,329998,5090e,AFSK_Tone
223153,100876,6097,330126,5098e,AFSK_Tone_AM
226925,100992,6153,334070,518f6,APRS_MicE
226385,101248,6153,333786,517da,APRS_Position
226501,100964,6121,333586,51712,APRS_Position_LoRa
224905,101008,6113,332026,510fa,AX25_Frames
224489,100864,6113,331466,50eca,AX25_Transmit
225033,100912,6121,332066,51122,AX25_Transmit_AFSK
225737,101148,6129,333014,514d6,BellModem_Transmit
216209,100856,6073,323138,4ee42,CC1101_Receive_Address
216093,100824,6073,322990,4edae,CC1101_Receive_Blocking
216201,100824,6081,323106,4ee22,CC1101_Receive_Interrupt
215253,101112,6433,322798,4ecee,CC1101_Settings
215045,100720,6073,321838,4e92e,CC1101_Transmit_Address
215329,100716,6081,322126,4ea4e,CC1101_Transmit_Blocking
215421,100788,6089,322298,4eafa,CC1101_Transmit_Interrupt
223701,100880,6145,330726,50be6,FSK4_Transmit
223733,100880,6153,330766,50c0e,FSK4_Transmit_AFSK
225725,101448,6121,333294,515ee,Hellschreiber_Transmit
225813,101464,6129,333406,5165e,Hellschreiber_Transmit_AFSK
221609,101072,6113,328794,5045a,LR11x0_Channel_Activity_Detection_Blocking
221777,101148,6121,329046,50556,LR11x0_Channel_Activity_Detection_Interrupt
222173,346332,6113,574618,8c49a,LR11x0_Firmware_Update
222601,101244,6113,329958,508e6,LR11x0_GFSK_Modem
223589,101416,6193,331198,50dbe,LR11x0_GNSS_Almanac_Update
223561,101268,6129,330958,50cce,LR11x0_GNSS_Autonomous_Position
223005,101308,6121,330434,50ac2,LR11x0_GNSS_Satellites
221457,100992,6113,328562,50372,LR11x0_LR_FHSS_Modem
222981,101260,6121,330362,50a7a,LR11x0_PingPong
222753,101192,6113,330058,5094a,LR11x0_Receive_Blocking
222849,101192,6121,330162,509b2,LR11x0_Receive_Interrupt
222553,101124,6121,329798,50846,LR11x0_Transmit_Blocking
222149,101156,6129,329434,506da,LR11x0_Transmit_Interrupt
223773,101244,6113,331130,50d7a,LR11x0_WiFi_Scan_Blocking
223825,101292,6121,331238,50de6,LR11x0_WiFi_Scan_Interrupt
239065,102836,7457,349358,554ae,LoRaWAN_ABP
240689,103356,7473,351518,55d1e,LoRaWAN_Reference
239025,102852,7473,349350,554a6,LoRaWAN_Starter
224209,100912,6161,331282,50e12,Morse_Receive_AM
225949,101252,6161,333362,51632,Morse_Transmit_AM
225865,101192,6161,333218,515a2,Morse_Transmit_FM
225829,101192,6153,333174,51576,Morse_Transmit_SSB
225881,101040,6137,333058,51502,Pager_Receive
225733,100944,6137,332814,5140e,Pager_Transmit
224457,101100,6089,331646,50f7e,PhysicalLayer_Interface
214845,100676,6081,321602,4e842,RF69_Receive_AES
215005,100752,6081,321838,4e92e,RF69_Receive_Address
215205,100684,6081,321970,4e9b2,RF69_Receive_Blocking
215333,100712,6089,322134,4ea56,RF69_Receive_Interrupt
214793,101172,6449,322414,4eb6e,RF69_Settings
214281,100608,6081,320970,4e5ca,RF69_Transmit_AES
214441,100700,6081,321222,4e6c6,RF69_Transmit_Address
214585,100620,6089,321294,4e70e,RF69_Transmit_Blocking
214677,100692,6097,321466,4e7ba,RF69_Transmit_Interrupt
225949,101112,6129,333190,51586,RTTY_Transmit
225989,101112,6137,333238,515b6,RTTY_Transmit_AFSK
224541,102300,6225,333066,5150a,SSTV_Transmit
224597,102300,6233,333130,5154a,SSTV_Transmit_AFSK
214657,100868,6081,321606,4e846,SX123x_Receive_Blocking
214473,100844,6089,321406,4e77e,SX123x_Transmit_Blocking
225113,101072,6153,332338,51232,SX126x_Channel_Activity_Detection_Blocking
225281,101132,6161,332574,5131e,SX126x_Channel_Activity_Detection_Interrupt
226905,101360,6161,334426,51a5a,SX126x_Channel_Activity_Detection_Receive
226093,101388,6153,333634,51742,SX126x_FSK_Modem
225325,101184,6153,332662,51376,SX126x_LR_FHSS_Modem
226485,101244,6161,333890,51842,SX126x_PingPong
226593,101236,6153,333982,5189e,SX126x_Receive_Blocking
226689,101236,6161,334086,51906,SX126x_Receive_Interrupt
226281,101768,6593,334642,51b32,SX126x_Settings
225717,102668,6153,334538,51aca,SX126x_Spectrum_Scan
226249,102680,6153,335082,51cea,SX126x_Spectrum_Scan_Frequency
226053,101108,6161,333322,5160a,SX126x_Transmit_Blocking
225653,101140,6169,332962,514a2,SX126x_Transmit_Interrupt
222797,100848,6089,329734,50806,SX127x_Channel_Activity_Detection_Blocking
222985,100864,6089,329938,508d2,SX127x_Channel_Activity_Detection_Interrupt
224857,101168,6089,332114,51152,SX127x_Channel_Activity_Detection_Receive
224113,101420,6089,331622,50f66,SX127x_FSK_Modem
224197,101036,6097,331330,50e42,SX127x_PingPong
224509,101028,6089,331626,50f6a,SX127x_Receive_Blocking
223049,100844,6089,329982,508fe,SX127x_Receive_Direct
223913,101088,6097,331098,50d5a,SX127x_Receive_FHSS
224609,101060,6089,331758,50fee,SX127x_Receive_Interrupt
226149,101480,6457,334086,51906,SX127x_Settings
223765,100900,6089,330754,50c02,SX127x_Transmit_Blocking
223941,101344,6121,331406,50e8e,SX127x_Transmit_FHSS
223361,100932,6097,330390,50a96,SX127x_Transmit_Interrupt
216889,101344,6089,324322,4f2e2,SX128x_BLE_Modem
215765,101056,6089,322910,4ed5e,SX128x_Channel_Activity_Detection_Blocking
215933,101132,6089,323154,4ee52,SX128x_Channel_Activity_Detection_Interrupt
216949,101388,6089,324426,4f34a,SX128x_FLRC_Modem
216601,101388,6089,324078,4f1ee,SX128x_GFSK_Modem
217489,101080,6089,324658,4f432,SX128x_Ranging
217581,101236,6089,324906,4f52a,SX128x_Receive_Blocking
217689,101236,6089,325014,4f596,SX128x_Receive_Interrupt
216417,101384,6457,324258,4f2a2,SX128x_Settings
216209,101068,6089,323366,4ef26,SX128x_Transmit_Blocking
216305,101140,6097,323542,4efd6,SX128x_Transmit_Interrupt
216261,100868,6073,323202,4ee82,Si443x_Receive_Blocking
216373,100868,6073,323314,4eef2,Si443x_Receive_Interrupt
216069,101272,6425,323766,4f0b6,Si443x_Settings
216125,100844,6073,323042,4ede2,Si443x_Transmit_Blocking
216201,100916,6081,323198,4ee7e,Si443x_Transmit_Interrupt
223109,100876,6609,330594,50b62,Stream_Receive
223173,101396,6121,330690,50bc2,Stream_Transmit
212393,100720,6057,319170,4dec2,nRF24_Receive_Blocking
212497,100752,6065,319314,4df52,nRF24_Receive_Interrupt
212213,100684,6065,318962,4ddf2,nRF24_Transmit_Blocking
212305,100768,6073,319146,4deaa,nRF24_Transmit_Interrupt
