text,data,bss,dec,hex,filename
31540,686,770,32996,80e4,../../../examples/AFSK/AFSK_Imperial_March/build/arduino.avr.mega/AFSK_Imperial_March.ino.elf
31266,342,770,32378,7e7a,../../../examples/AFSK/AFSK_Tone/build/arduino.avr.mega/AFSK_Tone.ino.elf
31436,342,770,32548,7f24,../../../examples/AFSK/AFSK_Tone_AM/build/arduino.avr.mega/AFSK_Tone_AM.ino.elf
36286,390,805,37481,9269,../../../examples/APRS/APRS_MicE/build/arduino.avr.mega/APRS_MicE.ino.elf
37084,488,805,38377,95e9,../../../examples/APRS/APRS_Position/build/arduino.avr.mega/APRS_Position.ino.elf
35740,428,783,36951,9057,../../../examples/APRS/APRS_Position_LoRa/build/arduino.avr.mega/APRS_Position_LoRa.ino.elf
33512,402,780,34694,8786,../../../examples/AX25/AX25_Frames/build/arduino.avr.mega/AX25_Frames.ino.elf
33062,366,780,34208,85a0,../../../examples/AX25/AX25_Transmit/build/arduino.avr.mega/AX25_Transmit.ino.elf
33870,384,786,35040,88e0,../../../examples/AX25/AX25_Transmit_AFSK/build/arduino.avr.mega/AX25_Transmit_AFSK.ino.elf
34016,410,793,35219,8993,../../../examples/BellModem/BellModem_Transmit/build/arduino.avr.mega/BellModem_Transmit.ino.elf
21440,386,755,22581,5835,../../../examples/CC1101/CC1101_Receive_Address/build/arduino.avr.mega/CC1101_Receive_Address.ino.elf
21320,386,755,22461,57bd,../../../examples/CC1101/CC1101_Receive_Blocking/build/arduino.avr.mega/CC1101_Receive_Blocking.ino.elf
21406,386,756,22548,5814,../../../examples/CC1101/CC1101_Receive_Interrupt/build/arduino.avr.mega/CC1101_Receive_Interrupt.ino.elf
21464,374,1097,22935,5997,../../../examples/CC1101/CC1101_Settings/build/arduino.avr.mega/CC1101_Settings.ino.elf
20132,388,755,21275,531b,../../../examples/CC1101/CC1101_Transmit_Address/build/arduino.avr.mega/CC1101_Transmit_Address.ino.elf
21072,390,757,22219,56cb,../../../examples/CC1101/CC1101_Transmit_Blocking/build/arduino.avr.mega/CC1101_Transmit_Blocking.ino.elf
21174,402,760,22336,5740,../../../examples/CC1101/CC1101_Transmit_Interrupt/build/arduino.avr.mega/CC1101_Transmit_Interrupt.ino.elf
32244,388,820,33452,82ac,../../../examples/FSK4/FSK4_Transmit/build/arduino.avr.mega/FSK4_Transmit.ino.elf
32274,388,826,33488,82d0,../../../examples/FSK4/FSK4_Transmit_AFSK/build/arduino.avr.mega/FSK4_Transmit_AFSK.ino.elf
34390,386,786,35562,8aea,../../../examples/Hellschreiber/Hellschreiber_Transmit/build/arduino.avr.mega/Hellschreiber_Transmit.ino.elf
34490,402,792,35684,8b64,../../../examples/Hellschreiber/Hellschreiber_Transmit_AFSK/build/arduino.avr.mega/Hellschreiber_Transmit_AFSK.ino.elf
26066,566,789,27421,6b1d,../../../examples/LR11x0/LR11x0_Channel_Activity_Detection_Blocking/build/arduino.avr.mega/LR11x0_Channel_Activity_Detection_Blocking.ino.elf
26306,566,790,27662,6c0e,../../../examples/LR11x0/LR11x0_Channel_Activity_Detection_Interrupt/build/arduino.avr.mega/LR11x0_Channel_Activity_Detection_Interrupt.ino.elf
27614,400,789,28803,7083,../../../examples/LR11x0/LR11x0_GFSK_Modem/build/arduino.avr.mega/LR11x0_GFSK_Modem.ino.elf
26926,566,854,28346,6eba,../../../examples/LR11x0/LR11x0_GNSS_Almanac_Update/build/arduino.avr.mega/LR11x0_GNSS_Almanac_Update.ino.elf
27958,584,804,29346,72a2,../../../examples/LR11x0/LR11x0_GNSS_Autonomous_Position/build/arduino.avr.mega/LR11x0_GNSS_Autonomous_Position.ino.elf
27808,576,793,29177,71f9,../../../examples/LR11x0/LR11x0_GNSS_Satellites/build/arduino.avr.mega/LR11x0_GNSS_Satellites.ino.elf
26002,396,789,27187,6a33,../../../examples/LR11x0/LR11x0_LR_FHSS_Modem/build/arduino.avr.mega/LR11x0_LR_FHSS_Modem.ino.elf
27720,592,793,29105,71b1,../../../examples/LR11x0/LR11x0_PingPong/build/arduino.avr.mega/LR11x0_PingPong.ino.elf
27560,578,789,28927,70ff,../../../examples/LR11x0/LR11x0_Receive_Blocking/build/arduino.avr.mega/LR11x0_Receive_Blocking.ino.elf
27646,578,790,29014,7156,../../../examples/LR11x0/LR11x0_Receive_Interrupt/build/arduino.avr.mega/LR11x0_Receive_Interrupt.ino.elf
27478,594,791,28863,70bf,../../../examples/LR11x0/LR11x0_Transmit_Blocking/build/arduino.avr.mega/LR11x0_Transmit_Blocking.ino.elf
27184,594,794,28572,6f9c,../../../examples/LR11x0/LR11x0_Transmit_Interrupt/build/arduino.avr.mega/LR11x0_Transmit_Interrupt.ino.elf
29456,600,789,30845,787d,../../../examples/LR11x0/LR11x0_WiFi_Scan_Blocking/build/arduino.avr.mega/LR11x0_WiFi_Scan_Blocking.ino.elf
29576,600,790,30966,78f6,../../../examples/LR11x0/LR11x0_WiFi_Scan_Interrupt/build/arduino.avr.mega/LR11x0_WiFi_Scan_Interrupt.ino.elf
55338,1750,2002,59090,e6d2,../../../examples/LoRaWAN/LoRaWAN_ABP/build/arduino.avr.mega/LoRaWAN_ABP.ino.elf
57698,1782,2000,61480,f028,../../../examples/LoRaWAN/LoRaWAN_Reference/build/arduino.avr.mega/LoRaWAN_Reference.ino.elf
55348,1750,2000,59098,e6da,../../../examples/LoRaWAN/LoRaWAN_Starter/build/arduino.avr.mega/LoRaWAN_Starter.ino.elf
33532,352,823,34707,8793,../../../examples/Morse/Morse_Receive_AM/build/arduino.avr.mega/Morse_Receive_AM.ino.elf
34550,380,821,35751,8ba7,../../../examples/Morse/Morse_Transmit_AM/build/arduino.avr.mega/Morse_Transmit_AM.ino.elf
34374,380,821,35575,8af7,../../../examples/Morse/Morse_Transmit_FM/build/arduino.avr.mega/Morse_Transmit_FM.ino.elf
34350,380,815,35545,8ad9,../../../examples/Morse/Morse_Transmit_SSB/build/arduino.avr.mega/Morse_Transmit_SSB.ino.elf
37098,352,803,38253,956d,../../../examples/Pager/Pager_Receive/build/arduino.avr.mega/Pager_Receive.ino.elf
37114,372,801,38287,958f,../../../examples/Pager/Pager_Transmit/build/arduino.avr.mega/Pager_Transmit.ino.elf
32798,366,764,33928,8488,../../../examples/PhysicalLayer/PhysicalLayer_Interface/build/arduino.avr.mega/PhysicalLayer_Interface.ino.elf
21186,350,759,22295,5717,../../../examples/RF69/RF69_Receive_AES/build/arduino.avr.mega/RF69_Receive_AES.ino.elf
21452,334,759,22545,5811,../../../examples/RF69/RF69_Receive_Address/build/arduino.avr.mega/RF69_Receive_Address.ino.elf
21494,346,759,22599,5847,../../../examples/RF69/RF69_Receive_Blocking/build/arduino.avr.mega/RF69_Receive_Blocking.ino.elf
21562,346,760,22668,588c,../../../examples/RF69/RF69_Receive_Interrupt/build/arduino.avr.mega/RF69_Receive_Interrupt.ino.elf
22018,342,1105,23465,5ba9,../../../examples/RF69/RF69_Settings/build/arduino.avr.mega/RF69_Settings.ino.elf
20326,364,759,21449,53c9,../../../examples/RF69/RF69_Transmit_AES/build/arduino.avr.mega/RF69_Transmit_AES.ino.elf
20590,348,759,21697,54c1,../../../examples/RF69/RF69_Transmit_Address/build/arduino.avr.mega/RF69_Transmit_Address.ino.elf
21276,350,761,22387,5773,../../../examples/RF69/RF69_Transmit_Blocking/build/arduino.avr.mega/RF69_Transmit_Blocking.ino.elf
21382,362,764,22508,57ec,../../../examples/RF69/RF69_Transmit_Interrupt/build/arduino.avr.mega/RF69_Transmit_Interrupt.ino.elf
34492,378,794,35664,8b50,../../../examples/RTTY/RTTY_Transmit/build/arduino.avr.mega/RTTY_Transmit.ino.elf
34516,378,800,35694,8b6e,../../../examples/RTTY/RTTY_Transmit_AFSK/build/arduino.avr.mega/RTTY_Transmit_AFSK.ino.elf
33202,1702,856,35760,8bb0,../../../examples/SSTV/SSTV_Transmit/build/arduino.avr.mega/SSTV_Transmit.ino.elf
33254,1702,862,35818,8bea,../../../examples/SSTV/SSTV_Transmit_AFSK/build/arduino.avr.mega/SSTV_Transmit_AFSK.ino.elf
20944,334,760,22038,5616,../../../examples/SX123x/SX123x_Receive_Blocking/build/arduino.avr.mega/SX123x_Receive_Blocking.ino.elf
21008,350,762,22120,5668,../../../examples/SX123x/SX123x_Transmit_Blocking/build/arduino.avr.mega/SX123x_Transmit_Blocking.ino.elf
34558,578,817,35953,8c71,../../../examples/SX126x/SX126x_Channel_Activity_Detection_Blocking/build/arduino.avr.mega/SX126x_Channel_Activity_Detection_Blocking.ino.elf
34788,578,818,36184,8d58,../../../examples/SX126x/SX126x_Channel_Activity_Detection_Interrupt/build/arduino.avr.mega/SX126x_Channel_Activity_Detection_Interrupt.ino.elf
36744,590,819,38153,9509,../../../examples/SX126x/SX126x_Channel_Activity_Detection_Receive/build/arduino.avr.mega/SX126x_Channel_Activity_Detection_Receive.ino.elf
36072,598,817,37487,926f,../../../examples/SX126x/SX126x_FSK_Modem/build/arduino.avr.mega/SX126x_FSK_Modem.ino.elf
34786,594,817,36197,8d65,../../../examples/SX126x/SX126x_LR_FHSS_Modem/build/arduino.avr.mega/SX126x_LR_FHSS_Modem.ino.elf
36188,602,821,37611,92eb,../../../examples/SX126x/SX126x_PingPong/build/arduino.avr.mega/SX126x_PingPong.ino.elf
36292,590,817,37699,9343,../../../examples/SX126x/SX126x_Receive_Blocking/build/arduino.avr.mega/SX126x_Receive_Blocking.ino.elf
36380,590,818,37788,939c,../../../examples/SX126x/SX126x_Receive_Interrupt/build/arduino.avr.mega/SX126x_Receive_Interrupt.ino.elf
37246,796,1219,39261,995d,../../../examples/SX126x/SX126x_Settings/build/arduino.avr.mega/SX126x_Settings.ino.elf
37122,588,817,38527,967f,../../../examples/SX126x/SX126x_Spectrum_Scan/build/arduino.avr.mega/SX126x_Spectrum_Scan.ino.elf
37562,606,817,38985,9849,../../../examples/SX126x/SX126x_Spectrum_Scan_Frequency/build/arduino.avr.mega/SX126x_Spectrum_Scan_Frequency.ino.elf
36010,604,819,37433,9239,../../../examples/SX126x/SX126x_Transmit_Blocking/build/arduino.avr.mega/SX126x_Transmit_Blocking.ino.elf
35724,606,822,37152,9120,../../../examples/SX126x/SX126x_Transmit_Interrupt/build/arduino.avr.mega/SX126x_Transmit_Interrupt.ino.elf
30756,342,764,31862,7c76,../../../examples/SX127x/SX127x_Channel_Activity_Detection_Blocking/build/arduino.avr.mega/SX127x_Channel_Activity_Detection_Blocking.ino.elf
31112,342,766,32220,7ddc,../../../examples/SX127x/SX127x_Channel_Activity_Detection_Interrupt/build/arduino.avr.mega/SX127x_Channel_Activity_Detection_Interrupt.ino.elf
33138,354,767,34259,85d3,../../../examples/SX127x/SX127x_Channel_Activity_Detection_Receive/build/arduino.avr.mega/SX127x_Channel_Activity_Detection_Receive.ino.elf
33140,362,764,34266,85da,../../../examples/SX127x/SX127x_FSK_Modem/build/arduino.avr.mega/SX127x_FSK_Modem.ino.elf
32444,366,768,33578,832a,../../../examples/SX127x/SX127x_PingPong/build/arduino.avr.mega/SX127x_PingPong.ino.elf
32666,354,764,33784,83f8,../../../examples/SX127x/SX127x_Receive_Blocking/build/arduino.avr.mega/SX127x_Receive_Blocking.ino.elf
31020,382,764,32166,7da6,../../../examples/SX127x/SX127x_Receive_Direct/build/arduino.avr.mega/SX127x_Receive_Direct.ino.elf
32382,366,768,33516,82ec,../../../examples/SX127x/SX127x_Receive_FHSS/build/arduino.avr.mega/SX127x_Receive_FHSS.ino.elf
32764,354,765,33883,845b,../../../examples/SX127x/SX127x_Receive_Interrupt/build/arduino.avr.mega/SX127x_Receive_Interrupt.ino.elf
35826,450,1115,37391,920f,../../../examples/SX127x/SX127x_Settings/build/arduino.avr.mega/SX127x_Settings.ino.elf
32262,368,766,33396,8274,../../../examples/SX127x/SX127x_Transmit_Blocking/build/arduino.avr.mega/SX127x_Transmit_Blocking.ino.elf
32996,586,778,34360,8638,../../../examples/SX127x/SX127x_Transmit_FHSS/build/arduino.avr.mega/SX127x_Transmit_FHSS.ino.elf
31970,370,769,33109,8155,../../../examples/SX127x/SX127x_Transmit_Interrupt/build/arduino.avr.mega/SX127x_Transmit_Interrupt.ino.elf
24468,364,767,25599,63ff,../../../examples/SX128x/SX128x_BLE_Modem/build/arduino.avr.mega/SX128x_BLE_Modem.ino.elf
22784,350,767,23901,5d5d,../../../examples/SX128x/SX128x_Channel_Activity_Detection_Blocking/build/arduino.avr.mega/SX128x_Channel_Activity_Detection_Blocking.ino.elf
23014,350,768,24132,5e44,../../../examples/SX128x/SX128x_Channel_Activity_Detection_Interrupt/build/arduino.avr.mega/SX128x_Channel_Activity_Detection_Interrupt.ino.elf
24558,372,767,25697,6461,../../../examples/SX128x/SX128x_FLRC_Modem/build/arduino.avr.mega/SX128x_FLRC_Modem.ino.elf
24172,368,767,25307,62db,../../../examples/SX128x/SX128x_GFSK_Modem/build/arduino.avr.mega/SX128x_GFSK_Modem.ino.elf
24912,398,767,26077,65dd,../../../examples/SX128x/SX128x_Ranging/build/arduino.avr.mega/SX128x_Ranging.ino.elf
25306,362,767,26435,6743,../../../examples/SX128x/SX128x_Receive_Blocking/build/arduino.avr.mega/SX128x_Receive_Blocking.ino.elf
25402,362,768,26532,67a4,../../../examples/SX128x/SX128x_Receive_Interrupt/build/arduino.avr.mega/SX128x_Receive_Interrupt.ino.elf
24320,350,1121,25791,64bf,../../../examples/SX128x/SX128x_Settings/build/arduino.avr.mega/SX128x_Settings.ino.elf
23836,366,769,24971,618b,../../../examples/SX128x/SX128x_Transmit_Blocking/build/arduino.avr.mega/SX128x_Transmit_Blocking.ino.elf
23944,378,772,25094,6206,../../../examples/SX128x/SX128x_Transmit_Interrupt/build/arduino.avr.mega/SX128x_Transmit_Interrupt.ino.elf
21842,334,752,22928,5990,../../../examples/Si443x/Si443x_Receive_Blocking/build/arduino.avr.mega/Si443x_Receive_Blocking.ino.elf
21924,334,753,23011,59e3,../../../examples/Si443x/Si443x_Receive_Interrupt/build/arduino.avr.mega/Si443x_Receive_Interrupt.ino.elf
23286,338,1091,24715,608b,../../../examples/Si443x/Si443x_Settings/build/arduino.avr.mega/Si443x_Settings.ino.elf
22030,350,754,23134,5a5e,../../../examples/Si443x/Si443x_Transmit_Blocking/build/arduino.avr.mega/Si443x_Transmit_Blocking.ino.elf
22112,362,757,23231,5abf,../../../examples/Si443x/Si443x_Transmit_Interrupt/build/arduino.avr.mega/Si443x_Transmit_Interrupt.ino.elf
31418,342,1280,33040,8110,../../../examples/Stream/Stream_Receive/build/arduino.avr.mega/Stream_Receive.ino.elf
32050,854,778,33682,8392,../../../examples/Stream/Stream_Transmit/build/arduino.avr.mega/Stream_Transmit.ino.elf
16910,340,742,17992,4648,../../../examples/nRF24/nRF24_Receive_Blocking/build/arduino.avr.mega/nRF24_Receive_Blocking.ino.elf
17002,340,743,18085,46a5,../../../examples/nRF24/nRF24_Receive_Interrupt/build/arduino.avr.mega/nRF24_Receive_Interrupt.ino.elf
17246,354,744,18344,47a8,../../../examples/nRF24/nRF24_Transmit_Blocking/build/arduino.avr.mega/nRF24_Transmit_Blocking.ino.elf
17322,368,747,18437,4805,../../../examples/nRF24/nRF24_Transmit_Interrupt/build/arduino.avr.mega/nRF24_Transmit_Interrupt.ino.elf
